area,areaid,dailydose1,dailydose2,daydiff,daytotal,referencedate,totaldistinctpersons,totaldose1,totaldose2,totalvaccinations
ΑΙΤΩΛΟΑΚΑΡΝΑΝΙΑΣ,701,273,88,-42,361,2021-03-11T00:00:00,10350,10350,4157,14507
ΑΝΑΤΟΛΙΚΗΣ ΑΤΤΙΚΗΣ,901,848,178,-42,1026,2021-03-11T00:00:00,21408,21408,9808,31216
ΑΝΔΡΟΥ,1201,8,10,18,18,2021-03-11T00:00:00,305,305,271,576
ΑΡΓΟΛΙΔΑΣ,1001,181,32,-30,213,2021-03-11T00:00:00,6546,6546,2964,9510
ΑΡΚΑΔΙΑΣ,1002,181,27,-15,208,2021-03-11T00:00:00,6497,6497,2818,9315
ΑΡΤΑΣ,401,88,69,-11,157,2021-03-11T00:00:00,4998,4998,3140,8138
ΑΧΑΪΑΣ,702,615,135,14,750,2021-03-11T00:00:00,18731,18731,9935,28666
ΒΟΙΩΤΙΑΣ,801,335,42,-19,377,2021-03-11T00:00:00,9449,9449,2733,12182
ΒΟΡΕΙΟΥ ΤΟΜΕΑ ΑΘΗΝΩΝ,902,3170,834,-313,4004,2021-03-11T00:00:00,118181,118181,46067,164248
ΓΡΕΒΕΝΩΝ,301,75,23,-11,98,2021-03-11T00:00:00,2685,2685,1208,3893
ΔΡΑΜΑΣ,101,230,35,7,265,2021-03-11T00:00:00,6485,6485,3198,9683
ΔΥΤΙΚΗΣ ΑΤΤΙΚΗΣ,903,197,25,-57,222,2021-03-11T00:00:00,7680,7680,2994,10674
ΔΥΤΙΚΟΥ ΤΟΜΕΑ ΑΘΗΝΩΝ,904,1227,189,31,1416,2021-03-11T00:00:00,31041,31041,17421,48462
ΕΒΡΟΥ,102,331,85,-33,416,2021-03-11T00:00:00,11884,11884,5414,17298
ΕΥΒΟΙΑΣ,802,456,104,2,560,2021-03-11T00:00:00,13985,13985,5915,19900
ΕΥΡΥΤΑΝΙΑΣ,803,35,10,-8,45,2021-03-11T00:00:00,1483,1483,676,2159
ΖΑΚΥΝΘΟΥ,601,64,24,1,88,2021-03-11T00:00:00,2276,2276,1336,3612
ΗΛΕΙΑΣ,703,307,47,-8,354,2021-03-11T00:00:00,8370,8370,3732,12102
ΗΜΑΘΙΑΣ,201,251,126,4,377,2021-03-11T00:00:00,9005,9005,4567,13572
ΗΡΑΚΛΕΙΟΥ,1301,511,175,-7,686,2021-03-11T00:00:00,19723,19723,9680,29403
ΘΑΣΟΥ,103,0,0,0,0,2021-03-11T00:00:00,441,441,427,868
ΘΕΣΠΡΩΤΙΑΣ,402,188,20,-2,208,2021-03-11T00:00:00,4825,4825,2175,7000
ΘΕΣΣΑΛΟΝΙΚΗΣ,202,2120,794,-85,2914,2021-03-11T00:00:00,93128,93129,43186,136315
ΘΗΡΑΣ,1202,47,1,-6,48,2021-03-11T00:00:00,811,811,370,1181
ΙΘΑΚΗΣ,602,0,0,-24,0,2021-03-11T00:00:00,574,574,79,653
ΙΚΑΡΙΑΣ,1101,17,7,-5,24,2021-03-11T00:00:00,1395,1395,676,2071
ΙΩΑΝΝΙΝΩΝ,403,291,182,-18,473,2021-03-11T00:00:00,14221,14222,8160,22382
ΚΑΒΑΛΑΣ,104,242,74,20,316,2021-03-11T00:00:00,7869,7869,4383,12252
ΚΑΛΥΜΝΟΥ,1203,7,11,-12,18,2021-03-11T00:00:00,1446,1446,708,2154
ΚΑΡΔΙΤΣΑΣ,501,235,124,-19,359,2021-03-11T00:00:00,10420,10420,4225,14645
ΚΑΡΠΑΘΟΥ,1204,0,0,-18,0,2021-03-11T00:00:00,472,472,255,727
ΚΑΣΤΟΡΙΑΣ,302,187,20,4,207,2021-03-11T00:00:00,4565,4565,2026,6591
ΚΕΑΣ-ΚΥΘΝΟΥ,1205,18,0,0,18,2021-03-11T00:00:00,96,96,38,134
ΚΕΝΤΡΙΚΟΥ ΤΟΜΕΑ ΑΘΗΝΩΝ,905,3604,1244,24,4848,2021-03-11T00:00:00,113878,113879,64103,177982
ΚΕΡΚΥΡΑΣ,603,255,43,-19,298,2021-03-11T00:00:00,6604,6604,3304,9908
ΚΕΦΑΛΛΗΝΙΑΣ,604,101,8,-26,109,2021-03-11T00:00:00,3901,3901,1636,5537
ΚΙΛΚΙΣ,203,211,58,-16,269,2021-03-11T00:00:00,6748,6748,3033,9781
ΚΟΖΑΝΗΣ,303,308,124,10,432,2021-03-11T00:00:00,9768,9768,4733,14501
ΚΟΡΙΝΘΙΑΣ,1003,234,69,-11,303,2021-03-11T00:00:00,7885,7885,3157,11042
ΚΩ,1206,83,8,-1,91,2021-03-11T00:00:00,2927,2927,934,3861
ΛΑΚΩΝΙΑΣ,1004,92,98,-37,190,2021-03-11T00:00:00,6901,6901,2965,9866
ΛΑΡΙΣΑΣ,502,265,187,-4,452,2021-03-11T00:00:00,16563,16563,8160,24723
ΛΑΣΙΘΙΟΥ,1302,213,46,-23,259,2021-03-11T00:00:00,7689,7689,4044,11733
ΛΕΣΒΟΥ,1102,180,25,3,205,2021-03-11T00:00:00,4971,4971,2592,7563
ΛΕΥΚΑΔΑΣ,605,55,73,-1,128,2021-03-11T00:00:00,3136,3136,1451,4587
ΛΗΜΝΟΥ,1103,48,0,0,48,2021-03-11T00:00:00,1233,1233,776,2009
ΜΑΓΝΗΣΙΑΣ,503,374,88,-17,462,2021-03-11T00:00:00,10838,10838,4699,15537
ΜΕΣΣΗΝΙΑΣ,1005,228,83,-25,311,2021-03-11T00:00:00,9987,9987,5078,15065
ΜΗΛΟΥ,1207,3,9,12,12,2021-03-11T00:00:00,452,452,235,687
ΜΥΚΟΝΟΥ,1208,5,7,12,12,2021-03-11T00:00:00,181,181,150,331
ΝΑΞΟΥ,1209,23,7,-6,30,2021-03-11T00:00:00,835,835,441,1276
ΝΗΣΩΝ,906,105,32,9,137,2021-03-11T00:00:00,3223,3223,1715,4938
ΝΟΤΙΟΥ ΤΟΜΕΑ ΑΘΗΝΩΝ,907,761,249,54,1010,2021-03-11T00:00:00,20766,20766,8539,29305
ΞΑΝΘΗΣ,105,187,35,14,222,2021-03-11T00:00:00,5416,5416,2400,7816
ΠΑΡΟΥ,1210,0,0,0,0,2021-03-11T00:00:00,310,310,296,606
ΠΕΙΡΑΙΩΣ,908,1194,284,19,1478,2021-03-11T00:00:00,32698,32698,15116,47814
ΠΕΛΛΑΣ,204,348,92,-29,440,2021-03-11T00:00:00,10424,10424,5446,15870
ΠΙΕΡΙΑΣ,205,223,77,5,300,2021-03-11T00:00:00,6604,6604,4076,10680
ΠΡΕΒΕΖΑΣ,404,137,38,5,175,2021-03-11T00:00:00,4413,4413,1162,5575
ΡΕΘΥΜΝΟΥ,1303,258,30,-2,288,2021-03-11T00:00:00,6811,6811,2477,9288
ΡΟΔΟΠΗΣ,106,157,64,8,221,2021-03-11T00:00:00,4810,4810,2258,7068
ΡΟΔΟΥ,1211,237,33,79,270,2021-03-11T00:00:00,5996,5996,2594,8590
ΣΑΜΟΥ,1104,44,12,-12,56,2021-03-11T00:00:00,2103,2103,906,3009
ΣΕΡΡΩΝ,206,266,75,-4,341,2021-03-11T00:00:00,10118,10118,3512,13630
ΣΠΟΡΑΔΩΝ,504,24,0,-18,24,2021-03-11T00:00:00,437,437,247,684
ΣΥΡΟΥ,1212,36,12,6,48,2021-03-11T00:00:00,1292,1292,869,2161
ΤΗΝΟΥ,1213,1,5,6,6,2021-03-11T00:00:00,315,315,284,599
ΤΡΙΚΑΛΩΝ,505,168,165,-11,333,2021-03-11T00:00:00,9907,9907,4907,14814
ΦΘΙΩΤΙΔΑΣ,804,270,107,8,377,2021-03-11T00:00:00,8468,8468,3708,12176
ΦΛΩΡΙΝΑΣ,304,175,15,-16,190,2021-03-11T00:00:00,4253,4253,1682,5935
ΦΩΚΙΔΑΣ,805,48,17,3,65,2021-03-11T00:00:00,2383,2383,1004,3387
ΧΑΛΚΙΔΙΚΗΣ,207,247,53,-27,300,2021-03-11T00:00:00,7748,7748,2479,10227
ΧΑΝΙΩΝ,1304,457,57,-1,514,2021-03-11T00:00:00,13375,13375,6841,20216
ΧΙΟΥ,1105,122,68,46,190,2021-03-11T00:00:00,4049,4049,1878,5927
ΑΙΤΩΛΟΑΚΑΡΝΑΝΙΑΣ,701,272,105,16,377,2021-03-12T00:00:00,10622,10622,4262,14884
ΑΝΑΤΟΛΙΚΗΣ ΑΤΤΙΚΗΣ,901,894,54,-78,948,2021-03-12T00:00:00,22302,22302,9862,32164
ΑΝΔΡΟΥ,1201,1,8,-9,9,2021-03-12T00:00:00,306,306,279,585
ΑΡΓΟΛΙΔΑΣ,1001,184,39,10,223,2021-03-12T00:00:00,6730,6730,3003,9733
ΑΡΚΑΔΙΑΣ,1002,221,10,23,231,2021-03-12T00:00:00,6718,6718,2828,9546
ΑΡΤΑΣ,401,63,98,4,161,2021-03-12T00:00:00,5061,5061,3238,8299
ΑΧΑΪΑΣ,702,583,146,-21,729,2021-03-12T00:00:00,19314,19314,10081,29395
ΒΟΙΩΤΙΑΣ,801,297,82,2,379,2021-03-12T00:00:00,9746,9746,2815,12561
ΒΟΡΕΙΟΥ ΤΟΜΕΑ ΑΘΗΝΩΝ,902,2198,1656,-150,3854,2021-03-12T00:00:00,120379,120379,47723,168102
ΓΡΕΒΕΝΩΝ,301,69,46,17,115,2021-03-12T00:00:00,2754,2754,1254,4008
ΔΡΑΜΑΣ,101,168,95,-2,263,2021-03-12T00:00:00,6653,6653,3293,9946
ΔΥΤΙΚΗΣ ΑΤΤΙΚΗΣ,903,194,13,-15,207,2021-03-12T00:00:00,7874,7874,3007,10881
ΔΥΤΙΚΟΥ ΤΟΜΕΑ ΑΘΗΝΩΝ,904,1185,195,-36,1380,2021-03-12T00:00:00,32226,32226,17616,49842
ΕΒΡΟΥ,102,320,124,28,444,2021-03-12T00:00:00,12204,12204,5538,17742
ΕΥΒΟΙΑΣ,802,354,167,-39,521,2021-03-12T00:00:00,14339,14339,6082,20421
ΕΥΡΥΤΑΝΙΑΣ,803,55,2,12,57,2021-03-12T00:00:00,1538,1538,678,2216
ΖΑΚΥΝΘΟΥ,601,69,7,-12,76,2021-03-12T00:00:00,2345,2345,1343,3688
ΗΛΕΙΑΣ,703,303,48,-3,351,2021-03-12T00:00:00,8673,8673,3780,12453
ΗΜΑΘΙΑΣ,201,230,153,6,383,2021-03-12T00:00:00,9235,9235,4720,13955
ΗΡΑΚΛΕΙΟΥ,1301,484,220,18,704,2021-03-12T00:00:00,20207,20207,9900,30107
ΘΑΣΟΥ,103,1,5,6,6,2021-03-12T00:00:00,442,442,432,874
ΘΕΣΠΡΩΤΙΑΣ,402,176,14,-18,190,2021-03-12T00:00:00,5001,5001,2189,7190
ΘΕΣΣΑΛΟΝΙΚΗΣ,202,2214,750,50,2964,2021-03-12T00:00:00,95342,95343,43936,139279
ΘΗΡΑΣ,1202,22,8,-18,30,2021-03-12T00:00:00,833,833,378,1211
ΙΘΑΚΗΣ,602,72,1,73,73,2021-03-12T00:00:00,646,646,80,726
ΙΚΑΡΙΑΣ,1101,29,6,11,35,2021-03-12T00:00:00,1424,1424,682,2106
ΙΩΑΝΝΙΝΩΝ,403,347,138,12,485,2021-03-12T00:00:00,14568,14569,8298,22867
ΚΑΒΑΛΑΣ,104,203,107,-6,310,2021-03-12T00:00:00,8072,8072,4490,12562
ΚΑΛΥΜΝΟΥ,1203,5,6,-7,11,2021-03-12T00:00:00,1451,1451,714,2165
ΚΑΡΔΙΤΣΑΣ,501,226,116,-17,342,2021-03-12T00:00:00,10646,10646,4341,14987
ΚΑΡΠΑΘΟΥ,1204,5,7,12,12,2021-03-12T00:00:00,477,477,262,739
ΚΑΣΤΟΡΙΑΣ,302,162,51,6,213,2021-03-12T00:00:00,4727,4727,2077,6804
ΚΕΑΣ-ΚΥΘΝΟΥ,1205,24,0,6,24,2021-03-12T00:00:00,120,120,38,158
ΚΕΝΤΡΙΚΟΥ ΤΟΜΕΑ ΑΘΗΝΩΝ,905,3628,1125,-95,4753,2021-03-12T00:00:00,117506,117507,65228,182735
ΚΕΡΚΥΡΑΣ,603,250,44,-4,294,2021-03-12T00:00:00,6854,6854,3348,10202
ΚΕΦΑΛΛΗΝΙΑΣ,604,79,8,-22,87,2021-03-12T00:00:00,3980,3980,1644,5624
ΚΙΛΚΙΣ,203,204,48,-17,252,2021-03-12T00:00:00,6952,6952,3081,10033
ΚΟΖΑΝΗΣ,303,341,88,-3,429,2021-03-12T00:00:00,10109,10109,4821,14930
ΚΟΡΙΝΘΙΑΣ,1003,219,70,-14,289,2021-03-12T00:00:00,8104,8104,3227,11331
ΚΩ,1206,188,5,102,193,2021-03-12T00:00:00,3115,3115,939,4054
ΛΑΚΩΝΙΑΣ,1004,81,128,19,209,2021-03-12T00:00:00,6982,6982,3093,10075
ΛΑΡΙΣΑΣ,502,303,201,52,504,2021-03-12T00:00:00,16866,16866,8361,25227
ΛΑΣΙΘΙΟΥ,1302,189,66,-4,255,2021-03-12T00:00:00,7878,7878,4110,11988
ΛΕΣΒΟΥ,1102,195,5,-5,200,2021-03-12T00:00:00,5166,5166,2597,7763
ΛΕΥΚΑΔΑΣ,605,67,12,-49,79,2021-03-12T00:00:00,3203,3203,1463,4666
ΛΗΜΝΟΥ,1103,47,1,0,48,2021-03-12T00:00:00,1280,1280,777,2057
ΜΑΓΝΗΣΙΑΣ,503,383,101,22,484,2021-03-12T00:00:00,11221,11221,4800,16021
ΜΕΣΣΗΝΙΑΣ,1005,200,155,44,355,2021-03-12T00:00:00,10187,10187,5233,15420
ΜΗΛΟΥ,1207,8,51,47,59,2021-03-12T00:00:00,460,460,286,746
ΜΥΚΟΝΟΥ,1208,2,4,-6,6,2021-03-12T00:00:00,183,183,154,337
ΝΑΞΟΥ,1209,22,2,-6,24,2021-03-12T00:00:00,857,857,443,1300
ΝΗΣΩΝ,906,203,15,81,218,2021-03-12T00:00:00,3426,3426,1730,5156
ΝΟΤΙΟΥ ΤΟΜΕΑ ΑΘΗΝΩΝ,907,708,230,-72,938,2021-03-12T00:00:00,21474,21474,8769,30243
ΞΑΝΘΗΣ,105,148,60,-14,208,2021-03-12T00:00:00,5564,5564,2460,8024
ΠΑΡΟΥ,1210,0,12,12,12,2021-03-12T00:00:00,310,310,308,618
ΠΕΙΡΑΙΩΣ,908,1188,256,-34,1444,2021-03-12T00:00:00,33886,33886,15372,49258
ΠΕΛΛΑΣ,204,327,92,-21,419,2021-03-12T00:00:00,10751,10751,5538,16289
ΠΙΕΡΙΑΣ,205,209,82,-9,291,2021-03-12T00:00:00,6813,6813,4158,10971
ΠΡΕΒΕΖΑΣ,404,134,54,13,188,2021-03-12T00:00:00,4547,4547,1216,5763
ΡΕΘΥΜΝΟΥ,1303,228,40,-20,268,2021-03-12T00:00:00,7039,7039,2517,9556
ΡΟΔΟΠΗΣ,106,119,94,-8,213,2021-03-12T00:00:00,4929,4929,2352,7281
ΡΟΔΟΥ,1211,248,88,66,336,2021-03-12T00:00:00,6244,6244,2682,8926
ΣΑΜΟΥ,1104,54,10,8,64,2021-03-12T00:00:00,2157,2157,916,3073
ΣΕΡΡΩΝ,206,200,148,7,348,2021-03-12T00:00:00,10318,10318,3660,13978
ΣΠΟΡΑΔΩΝ,504,42,6,24,48,2021-03-12T00:00:00,479,479,253,732
ΣΥΡΟΥ,1212,51,9,12,60,2021-03-12T00:00:00,1343,1343,878,2221
ΤΗΝΟΥ,1213,4,8,6,12,2021-03-12T00:00:00,319,319,292,611
ΤΡΙΚΑΛΩΝ,505,180,172,19,352,2021-03-12T00:00:00,10087,10087,5079,15166
ΦΘΙΩΤΙΔΑΣ,804,250,129,2,379,2021-03-12T00:00:00,8718,8718,3837,12555
ΦΛΩΡΙΝΑΣ,304,128,52,-10,180,2021-03-12T00:00:00,4381,4381,1734,6115
ΦΩΚΙΔΑΣ,805,32,41,8,73,2021-03-12T00:00:00,2415,2415,1045,3460
ΧΑΛΚΙΔΙΚΗΣ,207,273,51,24,324,2021-03-12T00:00:00,8021,8021,2530,10551
ΧΑΝΙΩΝ,1304,505,36,27,541,2021-03-12T00:00:00,13880,13880,6877,20757
ΧΙΟΥ,1105,123,28,-39,151,2021-03-12T00:00:00,4172,4172,1906,6078
ΑΙΤΩΛΟΑΚΑΡΝΑΝΙΑΣ,701,267,113,3,380,2021-03-13T00:00:00,10889,10889,4375,15264
ΑΝΑΤΟΛΙΚΗΣ ΑΤΤΙΚΗΣ,901,838,41,-69,879,2021-03-13T00:00:00,23140,23140,9903,33043
ΑΝΔΡΟΥ,1201,2,9,2,11,2021-03-13T00:00:00,308,308,288,596
ΑΡΓΟΛΙΔΑΣ,1001,215,47,39,262,2021-03-13T00:00:00,6945,6945,3050,9995
ΑΡΚΑΔΙΑΣ,1002,241,11,21,252,2021-03-13T00:00:00,6959,6959,2839,9798
ΑΡΤΑΣ,401,80,107,26,187,2021-03-13T00:00:00,5141,5141,3345,8486
ΑΧΑΪΑΣ,702,619,126,16,745,2021-03-13T00:00:00,19933,19933,10207,30140
ΒΟΙΩΤΙΑΣ,801,271,103,-5,374,2021-03-13T00:00:00,10017,10017,2918,12935
ΒΟΡΕΙΟΥ ΤΟΜΕΑ ΑΘΗΝΩΝ,902,1786,393,-1675,2179,2021-03-13T00:00:00,122165,122165,48116,170281
ΓΡΕΒΕΝΩΝ,301,52,48,-15,100,2021-03-13T00:00:00,2806,2806,1302,4108
ΔΡΑΜΑΣ,101,169,111,17,280,2021-03-13T00:00:00,6822,6822,3404,10226
ΔΥΤΙΚΗΣ ΑΤΤΙΚΗΣ,903,198,13,4,211,2021-03-13T00:00:00,8072,8072,3020,11092
ΔΥΤΙΚΟΥ ΤΟΜΕΑ ΑΘΗΝΩΝ,904,1154,198,-28,1352,2021-03-13T00:00:00,33380,33380,17814,51194
ΕΒΡΟΥ,102,301,184,41,485,2021-03-13T00:00:00,12505,12505,5722,18227
ΕΥΒΟΙΑΣ,802,347,124,-50,471,2021-03-13T00:00:00,14686,14686,6206,20892
ΕΥΡΥΤΑΝΙΑΣ,803,52,1,-4,53,2021-03-13T00:00:00,1590,1590,679,2269
ΖΑΚΥΝΘΟΥ,601,46,11,-19,57,2021-03-13T00:00:00,2391,2391,1354,3745
ΗΛΕΙΑΣ,703,298,54,1,352,2021-03-13T00:00:00,8971,8971,3834,12805
ΗΜΑΘΙΑΣ,201,200,180,-3,380,2021-03-13T00:00:00,9435,9435,4900,14335
ΗΡΑΚΛΕΙΟΥ,1301,502,214,12,716,2021-03-13T00:00:00,20709,20709,10114,30823
ΘΑΣΟΥ,103,0,0,-6,0,2021-03-13T00:00:00,442,442,432,874
ΘΕΣΠΡΩΤΙΑΣ,402,163,14,-13,177,2021-03-13T00:00:00,5164,5164,2203,7367
ΘΕΣΣΑΛΟΝΙΚΗΣ,202,2159,784,-21,2943,2021-03-13T00:00:00,97501,97502,44720,142222
ΘΗΡΑΣ,1202,30,0,0,30,2021-03-13T00:00:00,863,863,378,1241
ΙΘΑΚΗΣ,602,18,42,-13,60,2021-03-13T00:00:00,664,664,122,786
ΙΚΑΡΙΑΣ,1101,9,0,-26,9,2021-03-13T00:00:00,1433,1433,682,2115
ΙΩΑΝΝΙΝΩΝ,403,357,135,7,492,2021-03-13T00:00:00,14925,14926,8433,23359
ΚΑΒΑΛΑΣ,104,210,102,2,312,2021-03-13T00:00:00,8282,8282,4592,12874
ΚΑΛΥΜΝΟΥ,1203,4,6,-1,10,2021-03-13T00:00:00,1455,1455,720,2175
ΚΑΡΔΙΤΣΑΣ,501,261,57,-24,318,2021-03-13T00:00:00,10907,10907,4398,15305
ΚΑΡΠΑΘΟΥ,1204,1,3,-8,4,2021-03-13T00:00:00,478,478,265,743
ΚΑΣΤΟΡΙΑΣ,302,153,56,-4,209,2021-03-13T00:00:00,4880,4880,2133,7013
ΚΕΑΣ-ΚΥΘΝΟΥ,1205,24,0,0,24,2021-03-13T00:00:00,144,144,38,182
ΚΕΝΤΡΙΚΟΥ ΤΟΜΕΑ ΑΘΗΝΩΝ,905,3427,1105,-221,4532,2021-03-13T00:00:00,120933,120934,66333,187267
ΚΕΡΚΥΡΑΣ,603,302,38,46,340,2021-03-13T00:00:00,7156,7156,3386,10542
ΚΕΦΑΛΛΗΝΙΑΣ,604,62,3,-22,65,2021-03-13T00:00:00,4042,4042,1647,5689
ΚΙΛΚΙΣ,203,170,52,-30,222,2021-03-13T00:00:00,7122,7122,3133,10255
ΚΟΖΑΝΗΣ,303,357,78,6,435,2021-03-13T00:00:00,10466,10466,4899,15365
ΚΟΡΙΝΘΙΑΣ,1003,227,86,24,313,2021-03-13T00:00:00,8331,8331,3313,11644
ΚΩ,1206,73,71,-49,144,2021-03-13T00:00:00,3188,3188,1010,4198
ΛΑΚΩΝΙΑΣ,1004,61,130,-18,191,2021-03-13T00:00:00,7043,7043,3223,10266
ΛΑΡΙΣΑΣ,502,347,113,-44,460,2021-03-13T00:00:00,17213,17213,8474,25687
ΛΑΣΙΘΙΟΥ,1302,141,37,-77,178,2021-03-13T00:00:00,8019,8019,4147,12166
ΛΕΣΒΟΥ,1102,200,2,2,202,2021-03-13T00:00:00,5366,5366,2599,7965
ΛΕΥΚΑΔΑΣ,605,65,9,-5,74,2021-03-13T00:00:00,3268,3268,1472,4740
ΛΗΜΝΟΥ,1103,48,6,6,54,2021-03-13T00:00:00,1328,1328,783,2111
ΜΑΓΝΗΣΙΑΣ,503,344,116,-24,460,2021-03-13T00:00:00,11565,11565,4916,16481
ΜΕΣΣΗΝΙΑΣ,1005,191,144,-20,335,2021-03-13T00:00:00,10378,10378,5377,15755
ΜΗΛΟΥ,1207,0,0,-59,0,2021-03-13T00:00:00,460,460,286,746
ΜΥΚΟΝΟΥ,1208,0,0,-6,0,2021-03-13T00:00:00,183,183,154,337
ΝΑΞΟΥ,1209,23,1,0,24,2021-03-13T00:00:00,880,880,444,1324
ΝΗΣΩΝ,906,163,10,-45,173,2021-03-13T00:00:00,3589,3589,1740,5329
ΝΟΤΙΟΥ ΤΟΜΕΑ ΑΘΗΝΩΝ,907,717,182,-39,899,2021-03-13T00:00:00,22191,22191,8951,31142
ΞΑΝΘΗΣ,105,158,68,18,226,2021-03-13T00:00:00,5722,5722,2528,8250
ΠΑΡΟΥ,1210,0,0,-12,0,2021-03-13T00:00:00,310,310,308,618
ΠΕΙΡΑΙΩΣ,908,1142,278,-24,1420,2021-03-13T00:00:00,35028,35028,15650,50678
ΠΕΛΛΑΣ,204,380,64,25,444,2021-03-13T00:00:00,11131,11131,5602,16733
ΠΙΕΡΙΑΣ,205,257,42,8,299,2021-03-13T00:00:00,7070,7070,4200,11270
ΠΡΕΒΕΖΑΣ,404,134,48,-6,182,2021-03-13T00:00:00,4681,4681,1264,5945
ΡΕΘΥΜΝΟΥ,1303,177,56,-35,233,2021-03-13T00:00:00,7216,7216,2573,9789
ΡΟΔΟΠΗΣ,106,128,103,18,231,2021-03-13T00:00:00,5057,5057,2455,7512
ΡΟΔΟΥ,1211,265,306,235,571,2021-03-13T00:00:00,6509,6509,2988,9497
ΣΑΜΟΥ,1104,64,7,7,71,2021-03-13T00:00:00,2221,2221,923,3144
ΣΕΡΡΩΝ,206,195,165,12,360,2021-03-13T00:00:00,10513,10513,3825,14338
ΣΠΟΡΑΔΩΝ,504,6,23,-19,29,2021-03-13T00:00:00,485,485,276,761
ΣΥΡΟΥ,1212,42,6,-12,48,2021-03-13T00:00:00,1385,1385,884,2269
ΤΗΝΟΥ,1213,1,5,-6,6,2021-03-13T00:00:00,320,320,297,617
ΤΡΙΚΑΛΩΝ,505,179,144,-29,323,2021-03-13T00:00:00,10266,10266,5223,15489
ΦΘΙΩΤΙΔΑΣ,804,241,137,-1,378,2021-03-13T00:00:00,8959,8959,3974,12933
ΦΛΩΡΙΝΑΣ,304,127,44,-9,171,2021-03-13T00:00:00,4508,4508,1778,6286
ΦΩΚΙΔΑΣ,805,13,46,-14,59,2021-03-13T00:00:00,2428,2428,1091,3519
ΧΑΛΚΙΔΙΚΗΣ,207,203,58,-63,261,2021-03-13T00:00:00,8224,8224,2588,10812
ΧΑΝΙΩΝ,1304,479,34,-28,513,2021-03-13T00:00:00,14359,14359,6911,21270
ΧΙΟΥ,1105,115,30,-6,145,2021-03-13T00:00:00,4287,4287,1936,6223
ΑΙΤΩΛΟΑΚΑΡΝΑΝΙΑΣ,701,0,0,-380,0,2021-03-15T00:00:00,10889,10889,4375,15264
ΑΝΑΤΟΛΙΚΗΣ ΑΤΤΙΚΗΣ,901,5,31,-843,36,2021-03-15T00:00:00,23145,23145,9934,33079
ΑΝΔΡΟΥ,1201,0,0,-11,0,2021-03-15T00:00:00,308,308,288,596
ΑΡΓΟΛΙΔΑΣ,1001,0,0,-262,0,2021-03-15T00:00:00,6945,6945,3050,9995
ΑΡΚΑΔΙΑΣ,1002,0,0,-252,0,2021-03-15T00:00:00,6959,6959,2839,9798
ΑΡΤΑΣ,401,0,0,-187,0,2021-03-15T00:00:00,5141,5141,3345,8486
ΑΧΑΪΑΣ,702,0,0,-745,0,2021-03-15T00:00:00,19933,19933,10207,30140
ΒΟΙΩΤΙΑΣ,801,0,0,-374,0,2021-03-15T00:00:00,10017,10017,2918,12935
ΒΟΡΕΙΟΥ ΤΟΜΕΑ ΑΘΗΝΩΝ,902,13,278,-1888,291,2021-03-15T00:00:00,122178,122178,48394,170572
ΓΡΕΒΕΝΩΝ,301,0,0,-100,0,2021-03-15T00:00:00,2806,2806,1302,4108
ΔΡΑΜΑΣ,101,0,0,-280,0,2021-03-15T00:00:00,6822,6822,3404,10226
ΔΥΤΙΚΗΣ ΑΤΤΙΚΗΣ,903,0,0,-211,0,2021-03-15T00:00:00,8072,8072,3020,11092
ΔΥΤΙΚΟΥ ΤΟΜΕΑ ΑΘΗΝΩΝ,904,0,42,-1310,42,2021-03-15T00:00:00,33380,33380,17856,51236
ΕΒΡΟΥ,102,0,0,-485,0,2021-03-15T00:00:00,12505,12505,5722,18227
ΕΥΒΟΙΑΣ,802,0,0,-471,0,2021-03-15T00:00:00,14686,14686,6206,20892
ΕΥΡΥΤΑΝΙΑΣ,803,0,0,-53,0,2021-03-15T00:00:00,1590,1590,679,2269
ΖΑΚΥΝΘΟΥ,601,0,0,-57,0,2021-03-15T00:00:00,2391,2391,1354,3745
ΗΛΕΙΑΣ,703,0,0,-352,0,2021-03-15T00:00:00,8971,8971,3834,12805
ΗΜΑΘΙΑΣ,201,0,0,-380,0,2021-03-15T00:00:00,9435,9435,4900,14335
ΗΡΑΚΛΕΙΟΥ,1301,0,0,-716,0,2021-03-15T00:00:00,20709,20709,10114,30823
ΘΑΣΟΥ,103,0,0,0,0,2021-03-15T00:00:00,442,442,432,874
ΘΕΣΠΡΩΤΙΑΣ,402,0,0,-177,0,2021-03-15T00:00:00,5164,5164,2203,7367
ΘΕΣΣΑΛΟΝΙΚΗΣ,202,1,0,-2942,1,2021-03-15T00:00:00,97502,97503,44720,142223
ΘΗΡΑΣ,1202,0,0,-30,0,2021-03-15T00:00:00,863,863,378,1241
ΙΘΑΚΗΣ,602,0,0,-60,0,2021-03-15T00:00:00,664,664,122,786
ΙΚΑΡΙΑΣ,1101,0,0,-9,0,2021-03-15T00:00:00,1433,1433,682,2115
ΙΩΑΝΝΙΝΩΝ,403,0,0,-492,0,2021-03-15T00:00:00,14925,14926,8433,23359
ΚΑΒΑΛΑΣ,104,0,0,-312,0,2021-03-15T00:00:00,8282,8282,4592,12874
ΚΑΛΥΜΝΟΥ,1203,0,0,-10,0,2021-03-15T00:00:00,1455,1455,720,2175
ΚΑΡΔΙΤΣΑΣ,501,0,0,-318,0,2021-03-15T00:00:00,10907,10907,4398,15305
ΚΑΡΠΑΘΟΥ,1204,0,0,-4,0,2021-03-15T00:00:00,478,478,265,743
ΚΑΣΤΟΡΙΑΣ,302,0,0,-209,0,2021-03-15T00:00:00,4880,4880,2133,7013
ΚΕΑΣ-ΚΥΘΝΟΥ,1205,18,0,-6,18,2021-03-15T00:00:00,162,162,38,200
ΚΕΝΤΡΙΚΟΥ ΤΟΜΕΑ ΑΘΗΝΩΝ,905,75,915,-3542,990,2021-03-15T00:00:00,121008,121009,67248,188257
ΚΕΡΚΥΡΑΣ,603,24,0,-316,24,2021-03-15T00:00:00,7180,7180,3386,10566
ΚΕΦΑΛΛΗΝΙΑΣ,604,0,0,-65,0,2021-03-15T00:00:00,4042,4042,1647,5689
ΚΙΛΚΙΣ,203,0,0,-222,0,2021-03-15T00:00:00,7122,7122,3133,10255
ΚΟΖΑΝΗΣ,303,0,0,-435,0,2021-03-15T00:00:00,10466,10466,4899,15365
ΚΟΡΙΝΘΙΑΣ,1003,0,0,-313,0,2021-03-15T00:00:00,8331,8331,3313,11644
ΚΩ,1206,13,184,53,197,2021-03-15T00:00:00,3201,3201,1194,4395
ΛΑΚΩΝΙΑΣ,1004,0,0,-191,0,2021-03-15T00:00:00,7043,7043,3223,10266
ΛΑΡΙΣΑΣ,502,0,0,-460,0,2021-03-15T00:00:00,17213,17213,8474,25687
ΛΑΣΙΘΙΟΥ,1302,0,0,-178,0,2021-03-15T00:00:00,8019,8019,4147,12166
ΛΕΣΒΟΥ,1102,0,0,-202,0,2021-03-15T00:00:00,5366,5366,2599,7965
ΛΕΥΚΑΔΑΣ,605,9,3,-62,12,2021-03-15T00:00:00,3277,3277,1475,4752
ΛΗΜΝΟΥ,1103,0,0,-54,0,2021-03-15T00:00:00,1328,1328,783,2111
ΜΑΓΝΗΣΙΑΣ,503,0,0,-460,0,2021-03-15T00:00:00,11565,11565,4916,16481
ΜΕΣΣΗΝΙΑΣ,1005,3,3,-329,6,2021-03-15T00:00:00,10381,10381,5380,15761
ΜΗΛΟΥ,1207,0,0,0,0,2021-03-15T00:00:00,460,460,286,746
ΜΥΚΟΝΟΥ,1208,0,0,0,0,2021-03-15T00:00:00,183,183,154,337
ΝΑΞΟΥ,1209,0,0,-24,0,2021-03-15T00:00:00,880,880,444,1324
ΝΗΣΩΝ,906,24,0,-149,24,2021-03-15T00:00:00,3613,3613,1740,5353
ΝΟΤΙΟΥ ΤΟΜΕΑ ΑΘΗΝΩΝ,907,0,0,-899,0,2021-03-15T00:00:00,22191,22191,8951,31142
ΞΑΝΘΗΣ,105,0,0,-226,0,2021-03-15T00:00:00,5722,5722,2528,8250
ΠΑΡΟΥ,1210,0,0,0,0,2021-03-15T00:00:00,310,310,308,618
ΠΕΙΡΑΙΩΣ,908,9,129,-1282,138,2021-03-15T00:00:00,35037,35037,15779,50816
ΠΕΛΛΑΣ,204,4,0,-440,4,2021-03-15T00:00:00,11135,11135,5602,16737
ΠΙΕΡΙΑΣ,205,0,0,-299,0,2021-03-15T00:00:00,7070,7070,4200,11270
ΠΡΕΒΕΖΑΣ,404,0,0,-182,0,2021-03-15T00:00:00,4681,4681,1264,5945
ΡΕΘΥΜΝΟΥ,1303,0,0,-233,0,2021-03-15T00:00:00,7216,7216,2573,9789
ΡΟΔΟΠΗΣ,106,0,0,-231,0,2021-03-15T00:00:00,5057,5057,2455,7512
ΡΟΔΟΥ,1211,44,138,-389,182,2021-03-15T00:00:00,6553,6553,3126,9679
ΣΑΜΟΥ,1104,0,0,-71,0,2021-03-15T00:00:00,2221,2221,923,3144
ΣΕΡΡΩΝ,206,0,0,-360,0,2021-03-15T00:00:00,10513,10513,3825,14338
ΣΠΟΡΑΔΩΝ,504,0,0,-29,0,2021-03-15T00:00:00,485,485,276,761
ΣΥΡΟΥ,1212,0,0,-48,0,2021-03-15T00:00:00,1385,1385,884,2269
ΤΗΝΟΥ,1213,0,0,-6,0,2021-03-15T00:00:00,320,320,297,617
ΤΡΙΚΑΛΩΝ,505,0,0,-323,0,2021-03-15T00:00:00,10266,10266,5223,15489
ΦΘΙΩΤΙΔΑΣ,804,0,0,-378,0,2021-03-15T00:00:00,8959,8959,3974,12933
ΦΛΩΡΙΝΑΣ,304,0,0,-171,0,2021-03-15T00:00:00,4508,4508,1778,6286
ΦΩΚΙΔΑΣ,805,0,0,-59,0,2021-03-15T00:00:00,2428,2428,1091,3519
ΧΑΛΚΙΔΙΚΗΣ,207,0,0,-261,0,2021-03-15T00:00:00,8224,8224,2588,10812
ΧΑΝΙΩΝ,1304,0,0,-513,0,2021-03-15T00:00:00,14359,14359,6911,21270
ΧΙΟΥ,1105,0,0,-145,0,2021-03-15T00:00:00,4287,4287,1936,6223
ΑΙΤΩΛΟΑΚΑΡΝΑΝΙΑΣ,701,234,114,348,348,2021-03-16T00:00:00,11123,11123,4489,15612
ΑΝΑΤΟΛΙΚΗΣ ΑΤΤΙΚΗΣ,901,763,40,767,803,2021-03-16T00:00:00,23908,23908,9974,33882
ΑΝΔΡΟΥ,1201,1,0,1,1,2021-03-16T00:00:00,309,309,288,597
ΑΡΓΟΛΙΔΑΣ,1001,143,71,214,214,2021-03-16T00:00:00,7088,7088,3121,10209
ΑΡΚΑΔΙΑΣ,1002,104,85,189,189,2021-03-16T00:00:00,7063,7063,2924,9987
ΑΡΤΑΣ,401,100,94,194,194,2021-03-16T00:00:00,5241,5241,3439,8680
ΑΧΑΪΑΣ,702,541,250,791,791,2021-03-16T00:00:00,20474,20474,10457,30931
ΒΟΙΩΤΙΑΣ,801,126,176,302,302,2021-03-16T00:00:00,10143,10143,3094,13237
ΒΟΡΕΙΟΥ ΤΟΜΕΑ ΑΘΗΝΩΝ,902,956,2815,3480,3771,2021-03-16T00:00:00,123133,123134,51209,174343
ΓΡΕΒΕΝΩΝ,301,65,52,117,117,2021-03-16T00:00:00,2871,2871,1354,4225
ΔΡΑΜΑΣ,101,113,133,246,246,2021-03-16T00:00:00,6935,6935,3537,10472
ΔΥΤΙΚΗΣ ΑΤΤΙΚΗΣ,903,148,22,170,170,2021-03-16T00:00:00,8220,8220,3042,11262
ΔΥΤΙΚΟΥ ΤΟΜΕΑ ΑΘΗΝΩΝ,904,1159,308,1425,1467,2021-03-16T00:00:00,34539,34539,18164,52703
ΕΒΡΟΥ,102,165,268,433,433,2021-03-16T00:00:00,12670,12670,5990,18660
ΕΥΒΟΙΑΣ,802,269,306,575,575,2021-03-16T00:00:00,14955,14955,6512,21467
ΕΥΡΥΤΑΝΙΑΣ,803,24,31,55,55,2021-03-16T00:00:00,1614,1614,710,2324
ΖΑΚΥΝΘΟΥ,601,34,64,98,98,2021-03-16T00:00:00,2425,2425,1418,3843
ΗΛΕΙΑΣ,703,179,133,312,312,2021-03-16T00:00:00,9150,9150,3967,13117
ΗΜΑΘΙΑΣ,201,174,182,356,356,2021-03-16T00:00:00,9609,9609,5082,14691
ΗΡΑΚΛΕΙΟΥ,1301,459,300,759,759,2021-03-16T00:00:00,21168,21168,10414,31582
ΘΑΣΟΥ,103,0,0,0,0,2021-03-16T00:00:00,442,442,432,874
ΘΕΣΠΡΩΤΙΑΣ,402,83,98,181,181,2021-03-16T00:00:00,5247,5247,2301,7548
ΘΕΣΣΑΛΟΝΙΚΗΣ,202,2073,1589,3661,3662,2021-03-16T00:00:00,99575,99576,46309,145885
ΘΗΡΑΣ,1202,0,0,0,0,2021-03-16T00:00:00,863,863,378,1241
ΙΘΑΚΗΣ,602,52,8,60,60,2021-03-16T00:00:00,716,716,130,846
ΙΚΑΡΙΑΣ,1101,7,10,17,17,2021-03-16T00:00:00,1440,1440,692,2132
ΙΩΑΝΝΙΝΩΝ,403,245,255,500,500,2021-03-16T00:00:00,15170,15171,8688,23859
ΚΑΒΑΛΑΣ,104,228,126,354,354,2021-03-16T00:00:00,8510,8510,4718,13228
ΚΑΛΥΜΝΟΥ,1203,20,0,20,20,2021-03-16T00:00:00,1475,1475,720,2195
ΚΑΡΔΙΤΣΑΣ,501,277,52,329,329,2021-03-16T00:00:00,11184,11184,4450,15634
ΚΑΡΠΑΘΟΥ,1204,0,0,0,0,2021-03-16T00:00:00,478,478,265,743
ΚΑΣΤΟΡΙΑΣ,302,129,73,202,202,2021-03-16T00:00:00,5009,5009,2206,7215
ΚΕΑΣ-ΚΥΘΝΟΥ,1205,18,0,0,18,2021-03-16T00:00:00,180,180,38,218
ΚΕΝΤΡΙΚΟΥ ΤΟΜΕΑ ΑΘΗΝΩΝ,905,2825,1404,3239,4229,2021-03-16T00:00:00,123833,123834,68652,192486
ΚΕΡΚΥΡΑΣ,603,279,19,274,298,2021-03-16T00:00:00,7459,7459,3405,10864
ΚΕΦΑΛΛΗΝΙΑΣ,604,37,65,102,102,2021-03-16T00:00:00,4079,4079,1712,5791
ΚΙΛΚΙΣ,203,88,175,263,263,2021-03-16T00:00:00,7210,7210,3308,10518
ΚΟΖΑΝΗΣ,303,257,146,403,403,2021-03-16T00:00:00,10723,10723,5045,15768
ΚΟΡΙΝΘΙΑΣ,1003,228,49,277,277,2021-03-16T00:00:00,8559,8559,3362,11921
ΚΩ,1206,13,1,-183,14,2021-03-16T00:00:00,3214,3214,1195,4409
ΛΑΚΩΝΙΑΣ,1004,134,47,181,181,2021-03-16T00:00:00,7177,7177,3270,10447
ΛΑΡΙΣΑΣ,502,471,177,648,648,2021-03-16T00:00:00,17684,17684,8651,26335
ΛΑΣΙΘΙΟΥ,1302,91,138,229,229,2021-03-16T00:00:00,8110,8110,4285,12395
ΛΕΣΒΟΥ,1102,179,11,190,190,2021-03-16T00:00:00,5545,5545,2610,8155
ΛΕΥΚΑΔΑΣ,605,25,55,68,80,2021-03-16T00:00:00,3302,3302,1530,4832
ΛΗΜΝΟΥ,1103,51,0,51,51,2021-03-16T00:00:00,1379,1379,783,2162
ΜΑΓΝΗΣΙΑΣ,503,342,155,497,497,2021-03-16T00:00:00,11907,11907,5071,16978
ΜΕΣΣΗΝΙΑΣ,1005,173,169,336,342,2021-03-16T00:00:00,10554,10554,5549,16103
ΜΗΛΟΥ,1207,0,0,0,0,2021-03-16T00:00:00,460,460,286,746
ΜΥΚΟΝΟΥ,1208,5,7,12,12,2021-03-16T00:00:00,188,188,161,349
ΝΑΞΟΥ,1209,11,1,12,12,2021-03-16T00:00:00,891,891,445,1336
ΝΗΣΩΝ,906,143,20,139,163,2021-03-16T00:00:00,3756,3756,1760,5516
ΝΟΤΙΟΥ ΤΟΜΕΑ ΑΘΗΝΩΝ,907,450,420,870,870,2021-03-16T00:00:00,22641,22641,9371,32012
ΞΑΝΘΗΣ,105,88,155,243,243,2021-03-16T00:00:00,5810,5810,2683,8493
ΠΑΡΟΥ,1210,4,2,6,6,2021-03-16T00:00:00,314,314,310,624
ΠΕΙΡΑΙΩΣ,908,1074,317,1253,1391,2021-03-16T00:00:00,36111,36111,16096,52207
ΠΕΛΛΑΣ,204,325,53,374,378,2021-03-16T00:00:00,11460,11460,5655,17115
ΠΙΕΡΙΑΣ,205,264,67,331,331,2021-03-16T00:00:00,7334,7334,4267,11601
ΠΡΕΒΕΖΑΣ,404,101,50,151,151,2021-03-16T00:00:00,4782,4782,1314,6096
ΡΕΘΥΜΝΟΥ,1303,88,139,227,227,2021-03-16T00:00:00,7304,7304,2712,10016
ΡΟΔΟΠΗΣ,106,154,91,245,245,2021-03-16T00:00:00,5211,5211,2546,7757
ΡΟΔΟΥ,1211,117,191,126,308,2021-03-16T00:00:00,6670,6670,3317,9987
ΣΑΜΟΥ,1104,73,3,76,76,2021-03-16T00:00:00,2294,2294,926,3220
ΣΕΡΡΩΝ,206,199,175,374,374,2021-03-16T00:00:00,10712,10712,4000,14712
ΣΠΟΡΑΔΩΝ,504,3,4,7,7,2021-03-16T00:00:00,488,488,280,768
ΣΥΡΟΥ,1212,83,4,87,87,2021-03-16T00:00:00,1468,1468,888,2356
ΤΗΝΟΥ,1213,0,0,0,0,2021-03-16T00:00:00,320,320,297,617
ΤΡΙΚΑΛΩΝ,505,218,176,394,394,2021-03-16T00:00:00,10484,10484,5399,15883
ΦΘΙΩΤΙΔΑΣ,804,202,153,355,355,2021-03-16T00:00:00,9161,9161,4127,13288
ΦΛΩΡΙΝΑΣ,304,58,57,115,115,2021-03-16T00:00:00,4566,4566,1835,6401
ΦΩΚΙΔΑΣ,805,32,26,58,58,2021-03-16T00:00:00,2460,2460,1117,3577
ΧΑΛΚΙΔΙΚΗΣ,207,149,206,355,355,2021-03-16T00:00:00,8373,8373,2794,11167
ΧΑΝΙΩΝ,1304,299,188,487,487,2021-03-16T00:00:00,14658,14658,7099,21757
ΧΙΟΥ,1105,55,69,124,124,2021-03-16T00:00:00,4342,4342,2005,6347
ΑΙΤΩΛΟΑΚΑΡΝΑΝΙΑΣ,701,243,102,-3,345,2021-03-17T00:00:00,11366,11366,4591,15957
ΑΝΑΤΟΛΙΚΗΣ ΑΤΤΙΚΗΣ,901,798,25,20,823,2021-03-17T00:00:00,24706,24706,9999,34705
ΑΝΔΡΟΥ,1201,7,7,13,14,2021-03-17T00:00:00,316,316,295,611
ΑΡΓΟΛΙΔΑΣ,1001,189,31,6,220,2021-03-17T00:00:00,7277,7277,3152,10429
ΑΡΚΑΔΙΑΣ,1002,151,46,8,197,2021-03-17T00:00:00,7214,7214,2970,10184
ΑΡΤΑΣ,401,115,62,-17,177,2021-03-17T00:00:00,5356,5356,3501,8857
ΑΧΑΪΑΣ,702,525,183,-83,708,2021-03-17T00:00:00,20999,20999,10640,31639
ΒΟΙΩΤΙΑΣ,801,156,125,-21,281,2021-03-17T00:00:00,10299,10299,3219,13518
ΒΟΡΕΙΟΥ ΤΟΜΕΑ ΑΘΗΝΩΝ,902,1452,1974,-345,3426,2021-03-17T00:00:00,124585,124586,53183,177769
ΓΡΕΒΕΝΩΝ,301,69,46,-2,115,2021-03-17T00:00:00,2940,2940,1400,4340
ΔΡΑΜΑΣ,101,103,116,-27,219,2021-03-17T00:00:00,7038,7038,3653,10691
ΔΥΤΙΚΗΣ ΑΤΤΙΚΗΣ,903,109,0,-61,109,2021-03-17T00:00:00,8329,8329,3042,11371
ΔΥΤΙΚΟΥ ΤΟΜΕΑ ΑΘΗΝΩΝ,904,1128,129,-210,1257,2021-03-17T00:00:00,35667,35667,18293,53960
ΕΒΡΟΥ,102,198,224,-11,422,2021-03-17T00:00:00,12868,12868,6214,19082
ΕΥΒΟΙΑΣ,802,329,166,-80,495,2021-03-17T00:00:00,15284,15284,6678,21962
ΕΥΡΥΤΑΝΙΑΣ,803,30,8,-17,38,2021-03-17T00:00:00,1644,1644,718,2362
ΖΑΚΥΝΘΟΥ,601,58,48,8,106,2021-03-17T00:00:00,2483,2483,1466,3949
ΗΛΕΙΑΣ,703,260,73,21,333,2021-03-17T00:00:00,9410,9410,4040,13450
ΗΜΑΘΙΑΣ,201,226,131,1,357,2021-03-17T00:00:00,9835,9835,5213,15048
ΗΡΑΚΛΕΙΟΥ,1301,514,270,25,784,2021-03-17T00:00:00,21682,21682,10684,32366
ΘΑΣΟΥ,103,0,6,6,6,2021-03-17T00:00:00,442,442,438,880
ΘΕΣΠΡΩΤΙΑΣ,402,108,35,-38,143,2021-03-17T00:00:00,5355,5355,2336,7691
ΘΕΣΣΑΛΟΝΙΚΗΣ,202,2085,1656,79,3741,2021-03-17T00:00:00,101659,101661,47965,149626
ΘΗΡΑΣ,1202,0,12,12,12,2021-03-17T00:00:00,863,863,390,1253
ΙΘΑΚΗΣ,602,60,0,0,60,2021-03-17T00:00:00,776,776,130,906
ΙΚΑΡΙΑΣ,1101,1,5,-11,6,2021-03-17T00:00:00,1441,1441,697,2138
ΙΩΑΝΝΙΝΩΝ,403,249,230,-21,479,2021-03-17T00:00:00,15419,15420,8918,24338
ΚΑΒΑΛΑΣ,104,231,122,-1,353,2021-03-17T00:00:00,8741,8741,4840,13581
ΚΑΛΥΜΝΟΥ,1203,17,5,2,22,2021-03-17T00:00:00,1492,1492,725,2217
ΚΑΡΔΙΤΣΑΣ,501,283,36,-10,319,2021-03-17T00:00:00,11467,11467,4486,15953
ΚΑΡΠΑΘΟΥ,1204,0,0,0,0,2021-03-17T00:00:00,478,478,265,743
ΚΑΣΤΟΡΙΑΣ,302,133,55,-14,188,2021-03-17T00:00:00,5142,5142,2261,7403
ΚΕΑΣ-ΚΥΘΝΟΥ,1205,24,0,6,24,2021-03-17T00:00:00,204,204,38,242
ΚΕΝΤΡΙΚΟΥ ΤΟΜΕΑ ΑΘΗΝΩΝ,905,3074,830,-325,3904,2021-03-17T00:00:00,126907,126908,69482,196390
ΚΕΡΚΥΡΑΣ,603,237,17,-44,254,2021-03-17T00:00:00,7696,7696,3422,11118
ΚΕΦΑΛΛΗΝΙΑΣ,604,25,16,-61,41,2021-03-17T00:00:00,4104,4104,1728,5832
ΚΙΛΚΙΣ,203,64,134,-65,198,2021-03-17T00:00:00,7274,7274,3442,10716
ΚΟΖΑΝΗΣ,303,318,68,-17,386,2021-03-17T00:00:00,11041,11041,5113,16154
ΚΟΡΙΝΘΙΑΣ,1003,246,30,-1,276,2021-03-17T00:00:00,8805,8805,3392,12197
ΚΩ,1206,17,6,9,23,2021-03-17T00:00:00,3231,3231,1201,4432
ΛΑΚΩΝΙΑΣ,1004,168,26,13,194,2021-03-17T00:00:00,7345,7345,3296,10641
ΛΑΡΙΣΑΣ,502,491,61,-96,552,2021-03-17T00:00:00,18175,18175,8712,26887
ΛΑΣΙΘΙΟΥ,1302,111,82,-36,193,2021-03-17T00:00:00,8221,8221,4367,12588
ΛΕΣΒΟΥ,1102,180,8,-2,188,2021-03-17T00:00:00,5725,5725,2618,8343
ΛΕΥΚΑΔΑΣ,605,18,43,-19,61,2021-03-17T00:00:00,3320,3320,1573,4893
ΛΗΜΝΟΥ,1103,46,4,-1,50,2021-03-17T00:00:00,1425,1425,787,2212
ΜΑΓΝΗΣΙΑΣ,503,326,115,-56,441,2021-03-17T00:00:00,12233,12233,5186,17419
ΜΕΣΣΗΝΙΑΣ,1005,236,113,7,349,2021-03-17T00:00:00,10790,10790,5662,16452
ΜΗΛΟΥ,1207,0,0,0,0,2021-03-17T00:00:00,460,460,286,746
ΜΥΚΟΝΟΥ,1208,0,0,-12,0,2021-03-17T00:00:00,188,188,161,349
ΝΑΞΟΥ,1209,0,0,-12,0,2021-03-17T00:00:00,891,891,445,1336
ΝΗΣΩΝ,906,132,11,-20,143,2021-03-17T00:00:00,3888,3888,1771,5659
ΝΟΤΙΟΥ ΤΟΜΕΑ ΑΘΗΝΩΝ,907,562,245,-63,807,2021-03-17T00:00:00,23203,23203,9616,32819
ΞΑΝΘΗΣ,105,109,133,-1,242,2021-03-17T00:00:00,5919,5919,2816,8735
ΠΑΡΟΥ,1210,0,0,-6,0,2021-03-17T00:00:00,314,314,310,624
ΠΕΙΡΑΙΩΣ,908,1063,355,27,1418,2021-03-17T00:00:00,37174,37174,16451,53625
ΠΕΛΛΑΣ,204,326,19,-33,345,2021-03-17T00:00:00,11786,11786,5674,17460
ΠΙΕΡΙΑΣ,205,312,21,2,333,2021-03-17T00:00:00,7646,7646,4288,11934
ΠΡΕΒΕΖΑΣ,404,93,49,-9,142,2021-03-17T00:00:00,4875,4875,1363,6238
ΡΕΘΥΜΝΟΥ,1303,38,126,-63,164,2021-03-17T00:00:00,7342,7342,2838,10180
ΡΟΔΟΠΗΣ,106,156,71,-18,227,2021-03-17T00:00:00,5367,5367,2617,7984
ΡΟΔΟΥ,1211,160,99,-49,259,2021-03-17T00:00:00,6830,6830,3416,10246
ΣΑΜΟΥ,1104,58,1,-17,59,2021-03-17T00:00:00,2352,2352,927,3279
ΣΕΡΡΩΝ,206,176,162,-36,338,2021-03-17T00:00:00,10888,10888,4162,15050
ΣΠΟΡΑΔΩΝ,504,0,6,-1,6,2021-03-17T00:00:00,488,488,286,774
ΣΥΡΟΥ,1212,88,3,4,91,2021-03-17T00:00:00,1556,1556,891,2447
ΤΗΝΟΥ,1213,2,10,12,12,2021-03-17T00:00:00,322,322,307,629
ΤΡΙΚΑΛΩΝ,505,275,93,-26,368,2021-03-17T00:00:00,10759,10759,5492,16251
ΦΘΙΩΤΙΔΑΣ,804,206,159,10,365,2021-03-17T00:00:00,9367,9367,4286,13653
ΦΛΩΡΙΝΑΣ,304,44,56,-15,100,2021-03-17T00:00:00,4610,4610,1891,6501
ΦΩΚΙΔΑΣ,805,39,13,-6,52,2021-03-17T00:00:00,2499,2499,1130,3629
ΧΑΛΚΙΔΙΚΗΣ,207,120,170,-65,290,2021-03-17T00:00:00,8493,8493,2964,11457
ΧΑΝΙΩΝ,1304,301,109,-77,410,2021-03-17T00:00:00,14959,14959,7208,22167
ΧΙΟΥ,1105,54,67,-3,121,2021-03-17T00:00:00,4396,4396,2072,6468
ΑΙΤΩΛΟΑΚΑΡΝΑΝΙΑΣ,701,124,67,-5,191,2021-01-28T00:00:00,1904,1904,212,2116
ΑΝΑΤΟΛΙΚΗΣ ΑΤΤΙΚΗΣ,901,394,76,4,470,2021-01-28T00:00:00,3789,3789,607,4396
ΑΝΔΡΟΥ,1201,55,0,55,55,2021-01-28T00:00:00,55,55,0,55
ΑΡΓΟΛΙΔΑΣ,1001,128,1,-19,129,2021-01-28T00:00:00,1697,1697,1,1698
ΑΡΚΑΔΙΑΣ,1002,92,69,29,161,2021-01-28T00:00:00,1712,1712,69,1781
ΑΡΤΑΣ,401,77,49,-12,126,2021-01-28T00:00:00,1720,1720,192,1912
ΑΧΑΪΑΣ,702,323,254,43,577,2021-01-28T00:00:00,5663,5663,1353,7016
ΒΟΙΩΤΙΑΣ,801,158,4,7,162,2021-01-28T00:00:00,1646,1646,4,1650
ΒΟΡΕΙΟΥ ΤΟΜΕΑ ΑΘΗΝΩΝ,902,838,789,43,1627,2021-01-28T00:00:00,28548,28548,2428,30976
ΓΡΕΒΕΝΩΝ,301,50,0,2,50,2021-01-28T00:00:00,667,667,0,667
ΔΡΑΜΑΣ,101,150,0,0,150,2021-01-28T00:00:00,1771,1771,0,1771
ΔΥΤΙΚΗΣ ΑΤΤΙΚΗΣ,903,125,55,6,180,2021-01-28T00:00:00,1883,1883,389,2272
ΔΥΤΙΚΟΥ ΤΟΜΕΑ ΑΘΗΝΩΝ,904,578,156,-4,734,2021-01-28T00:00:00,8105,8105,800,8905
ΕΒΡΟΥ,102,227,1,-17,228,2021-01-28T00:00:00,3551,3551,1,3552
ΕΥΒΟΙΑΣ,802,275,49,-66,324,2021-01-28T00:00:00,3492,3492,49,3541
ΕΥΡΥΤΑΝΙΑΣ,803,36,0,6,36,2021-01-28T00:00:00,445,445,0,445
ΖΑΚΥΝΘΟΥ,601,48,0,-13,48,2021-01-28T00:00:00,873,873,0,873
ΗΛΕΙΑΣ,703,141,48,-14,189,2021-01-28T00:00:00,2207,2207,48,2255
ΗΜΑΘΙΑΣ,201,164,46,12,210,2021-01-28T00:00:00,2126,2126,188,2314
ΗΡΑΚΛΕΙΟΥ,1301,335,118,-19,453,2021-01-28T00:00:00,6638,6638,489,7127
ΘΑΣΟΥ,103,41,0,41,41,2021-01-28T00:00:00,41,41,0,41
ΘΕΣΠΡΩΤΙΑΣ,402,50,40,-12,90,2021-01-28T00:00:00,1214,1214,40,1254
ΘΕΣΣΑΛΟΝΙΚΗΣ,202,1040,945,-82,1985,2021-01-28T00:00:00,23303,23303,3759,27062
ΘΗΡΑΣ,1202,24,0,6,24,2021-01-28T00:00:00,209,209,0,209
ΙΘΑΚΗΣ,602,0,0,0,0,2021-01-28T00:00:00,0,0,0,0
ΙΚΑΡΙΑΣ,1101,24,0,12,24,2021-01-28T00:00:00,225,225,0,225
ΙΩΑΝΝΙΝΩΝ,403,197,217,-17,414,2021-01-28T00:00:00,5062,5062,1112,6174
ΚΑΒΑΛΑΣ,104,210,0,5,210,2021-01-28T00:00:00,2377,2377,2,2379
ΚΑΛΥΜΝΟΥ,1203,61,0,1,61,2021-01-28T00:00:00,500,500,0,500
ΚΑΡΔΙΤΣΑΣ,501,114,99,-9,213,2021-01-28T00:00:00,2124,2124,381,2505
ΚΑΡΠΑΘΟΥ,1204,18,0,18,18,2021-01-28T00:00:00,165,165,0,165
ΚΑΣΤΟΡΙΑΣ,302,90,0,-6,90,2021-01-28T00:00:00,1095,1095,0,1095
ΚΕΑΣ-ΚΥΘΝΟΥ,1205,0,0,0,0,2021-01-28T00:00:00,0,0,0,0
ΚΕΝΤΡΙΚΟΥ ΤΟΜΕΑ ΑΘΗΝΩΝ,905,1413,1809,-55,3222,2021-01-28T00:00:00,32950,32950,7645,40595
ΚΕΡΚΥΡΑΣ,603,84,0,-48,84,2021-01-28T00:00:00,1982,1982,0,1982
ΚΕΦΑΛΛΗΝΙΑΣ,604,134,0,44,134,2021-01-28T00:00:00,1146,1146,0,1146
ΚΙΛΚΙΣ,203,126,0,-12,126,2021-01-28T00:00:00,1632,1632,0,1632
ΚΟΖΑΝΗΣ,303,141,81,18,222,2021-01-28T00:00:00,1982,1982,394,2376
ΚΟΡΙΝΘΙΑΣ,1003,127,23,0,150,2021-01-28T00:00:00,1305,1305,165,1470
ΚΩ,1206,78,0,36,78,2021-01-28T00:00:00,593,593,1,594
ΛΑΚΩΝΙΑΣ,1004,45,105,19,150,2021-01-28T00:00:00,1747,1747,107,1854
ΛΑΡΙΣΑΣ,502,195,189,34,384,2021-01-28T00:00:00,4126,4126,1210,5336
ΛΑΣΙΘΙΟΥ,1302,239,1,-18,240,2021-01-28T00:00:00,2616,2616,1,2617
ΛΕΣΒΟΥ,1102,114,0,-18,114,2021-01-28T00:00:00,1591,1591,0,1591
ΛΕΥΚΑΔΑΣ,605,66,0,30,66,2021-01-28T00:00:00,639,639,0,639
ΛΗΜΝΟΥ,1103,23,0,-13,23,2021-01-28T00:00:00,490,490,0,490
ΜΑΓΝΗΣΙΑΣ,503,220,1,-49,221,2021-01-28T00:00:00,2148,2148,1,2149
ΜΕΣΣΗΝΙΑΣ,1005,183,45,-12,228,2021-01-28T00:00:00,2673,2673,45,2718
ΜΗΛΟΥ,1207,12,0,12,12,2021-01-28T00:00:00,12,12,0,12
ΜΥΚΟΝΟΥ,1208,36,0,36,36,2021-01-28T00:00:00,36,36,0,36
ΝΑΞΟΥ,1209,18,0,-12,18,2021-01-28T00:00:00,276,276,0,276
ΝΗΣΩΝ,906,187,0,169,187,2021-01-28T00:00:00,335,335,0,335
ΝΟΤΙΟΥ ΤΟΜΕΑ ΑΘΗΝΩΝ,907,288,0,12,288,2021-01-28T00:00:00,3796,3796,0,3796
ΞΑΝΘΗΣ,105,116,10,30,126,2021-01-28T00:00:00,1534,1534,10,1544
ΠΑΡΟΥ,1210,42,0,42,42,2021-01-28T00:00:00,42,42,0,42
ΠΕΙΡΑΙΩΣ,908,539,118,-46,657,2021-01-28T00:00:00,8207,8207,391,8598
ΠΕΛΛΑΣ,204,133,105,-68,238,2021-01-28T00:00:00,2132,2132,380,2512
ΠΙΕΡΙΑΣ,205,166,19,0,185,2021-01-28T00:00:00,1574,1574,273,1847
ΠΡΕΒΕΖΑΣ,404,8,46,3,54,2021-01-28T00:00:00,842,842,46,888
ΡΕΘΥΜΝΟΥ,1303,137,0,-1,137,2021-01-28T00:00:00,1615,1615,0,1615
ΡΟΔΟΠΗΣ,106,96,0,0,96,2021-01-28T00:00:00,1167,1167,0,1167
ΡΟΔΟΥ,1211,144,0,-100,144,2021-01-28T00:00:00,1621,1621,0,1621
ΣΑΜΟΥ,1104,30,0,-12,30,2021-01-28T00:00:00,592,592,2,594
ΣΕΡΡΩΝ,206,168,0,18,168,2021-01-28T00:00:00,1927,1927,0,1927
ΣΠΟΡΑΔΩΝ,504,42,0,42,42,2021-01-28T00:00:00,42,42,0,42
ΣΥΡΟΥ,1212,30,0,-12,30,2021-01-28T00:00:00,562,562,0,562
ΤΗΝΟΥ,1213,46,0,46,46,2021-01-28T00:00:00,46,46,0,46
ΤΡΙΚΑΛΩΝ,505,110,95,8,205,2021-01-28T00:00:00,2316,2316,379,2695
ΦΘΙΩΤΙΔΑΣ,804,117,45,-30,162,2021-01-28T00:00:00,2314,2314,45,2359
ΦΛΩΡΙΝΑΣ,304,78,0,-18,78,2021-01-28T00:00:00,1036,1036,0,1036
ΦΩΚΙΔΑΣ,805,42,0,-12,42,2021-01-28T00:00:00,600,600,0,600
ΧΑΛΚΙΔΙΚΗΣ,207,107,1,-36,108,2021-01-28T00:00:00,1242,1242,3,1245
ΧΑΝΙΩΝ,1304,212,142,-62,354,2021-01-28T00:00:00,3464,3464,575,4039
ΧΙΟΥ,1105,48,0,0,48,2021-01-28T00:00:00,731,731,0,731
ΑΙΤΩΛΟΑΚΑΡΝΑΝΙΑΣ,701,82,98,-11,180,2021-01-29T00:00:00,1986,1986,310,2296
ΑΝΑΤΟΛΙΚΗΣ ΑΤΤΙΚΗΣ,901,454,6,-10,460,2021-01-29T00:00:00,4243,4243,613,4856
ΑΝΔΡΟΥ,1201,53,0,-2,53,2021-01-29T00:00:00,108,108,0,108
ΑΡΓΟΛΙΔΑΣ,1001,51,110,32,161,2021-01-29T00:00:00,1748,1748,111,1859
ΑΡΚΑΔΙΑΣ,1002,59,92,-10,151,2021-01-29T00:00:00,1771,1771,161,1932
ΑΡΤΑΣ,401,76,80,30,156,2021-01-29T00:00:00,1796,1796,272,2068
ΑΧΑΪΑΣ,702,285,169,-123,454,2021-01-29T00:00:00,5948,5948,1522,7470
ΒΟΙΩΤΙΑΣ,801,59,91,-12,150,2021-01-29T00:00:00,1705,1705,95,1800
ΒΟΡΕΙΟΥ ΤΟΜΕΑ ΑΘΗΝΩΝ,902,1222,944,539,2166,2021-01-29T00:00:00,29770,29770,3372,33142
ΓΡΕΒΕΝΩΝ,301,9,45,4,54,2021-01-29T00:00:00,676,676,45,721
ΔΡΑΜΑΣ,101,51,93,-6,144,2021-01-29T00:00:00,1822,1822,93,1915
ΔΥΤΙΚΗΣ ΑΤΤΙΚΗΣ,903,130,26,-24,156,2021-01-29T00:00:00,2013,2013,415,2428
ΔΥΤΙΚΟΥ ΤΟΜΕΑ ΑΘΗΝΩΝ,904,479,461,206,940,2021-01-29T00:00:00,8584,8584,1261,9845
ΕΒΡΟΥ,102,124,92,-12,216,2021-01-29T00:00:00,3675,3675,93,3768
ΕΥΒΟΙΑΣ,802,220,157,53,377,2021-01-29T00:00:00,3712,3712,206,3918
ΕΥΡΥΤΑΝΙΑΣ,803,1,47,12,48,2021-01-29T00:00:00,446,446,47,493
ΖΑΚΥΝΘΟΥ,601,66,0,18,66,2021-01-29T00:00:00,939,939,0,939
ΗΛΕΙΑΣ,703,86,145,42,231,2021-01-29T00:00:00,2293,2293,193,2486
ΗΜΑΘΙΑΣ,201,102,102,-6,204,2021-01-29T00:00:00,2228,2228,290,2518
ΗΡΑΚΛΕΙΟΥ,1301,205,215,-33,420,2021-01-29T00:00:00,6843,6843,704,7547
ΘΑΣΟΥ,103,49,0,8,49,2021-01-29T00:00:00,90,90,0,90
ΘΕΣΠΡΩΤΙΑΣ,402,15,81,6,96,2021-01-29T00:00:00,1229,1229,121,1350
ΘΕΣΣΑΛΟΝΙΚΗΣ,202,915,997,-73,1912,2021-01-29T00:00:00,24218,24218,4756,28974
ΘΗΡΑΣ,1202,12,0,-12,12,2021-01-29T00:00:00,221,221,0,221
ΙΘΑΚΗΣ,602,0,0,0,0,2021-01-29T00:00:00,0,0,0,0
ΙΚΑΡΙΑΣ,1101,11,1,-12,12,2021-01-29T00:00:00,236,236,1,237
ΙΩΑΝΝΙΝΩΝ,403,187,151,-76,338,2021-01-29T00:00:00,5249,5249,1263,6512
ΚΑΒΑΛΑΣ,104,93,93,-24,186,2021-01-29T00:00:00,2470,2470,95,2565
ΚΑΛΥΜΝΟΥ,1203,22,1,-38,23,2021-01-29T00:00:00,522,522,1,523
ΚΑΡΔΙΤΣΑΣ,501,105,139,31,244,2021-01-29T00:00:00,2229,2229,520,2749
ΚΑΡΠΑΘΟΥ,1204,18,0,0,18,2021-01-29T00:00:00,183,183,0,183
ΚΑΣΤΟΡΙΑΣ,302,69,47,26,116,2021-01-29T00:00:00,1164,1164,47,1211
ΚΕΑΣ-ΚΥΘΝΟΥ,1205,0,0,0,0,2021-01-29T00:00:00,0,0,0,0
ΚΕΝΤΡΙΚΟΥ ΤΟΜΕΑ ΑΘΗΝΩΝ,905,1347,2186,311,3533,2021-01-29T00:00:00,34297,34297,9831,44128
ΚΕΡΚΥΡΑΣ,603,84,0,0,84,2021-01-29T00:00:00,2066,2066,0,2066
ΚΕΦΑΛΛΗΝΙΑΣ,604,97,0,-37,97,2021-01-29T00:00:00,1243,1243,0,1243
ΚΙΛΚΙΣ,203,19,95,-12,114,2021-01-29T00:00:00,1651,1651,95,1746
ΚΟΖΑΝΗΣ,303,148,50,-24,198,2021-01-29T00:00:00,2130,2130,444,2574
ΚΟΡΙΝΘΙΑΣ,1003,91,53,-6,144,2021-01-29T00:00:00,1396,1396,218,1614
ΚΩ,1206,36,0,-42,36,2021-01-29T00:00:00,629,629,1,630
ΛΑΚΩΝΙΑΣ,1004,14,125,-11,139,2021-01-29T00:00:00,1761,1761,232,1993
ΛΑΡΙΣΑΣ,502,128,196,-60,324,2021-01-29T00:00:00,4254,4254,1406,5660
ΛΑΣΙΘΙΟΥ,1302,123,150,33,273,2021-01-29T00:00:00,2739,2739,151,2890
ΛΕΣΒΟΥ,1102,120,0,6,120,2021-01-29T00:00:00,1711,1711,0,1711
ΛΕΥΚΑΔΑΣ,605,48,0,-18,48,2021-01-29T00:00:00,687,687,0,687
ΛΗΜΝΟΥ,1103,30,0,7,30,2021-01-29T00:00:00,520,520,0,520
ΜΑΓΝΗΣΙΑΣ,503,166,44,-11,210,2021-01-29T00:00:00,2314,2314,45,2359
ΜΕΣΣΗΝΙΑΣ,1005,125,145,42,270,2021-01-29T00:00:00,2798,2798,190,2988
ΜΗΛΟΥ,1207,6,0,-6,6,2021-01-29T00:00:00,18,18,0,18
ΜΥΚΟΝΟΥ,1208,18,0,-18,18,2021-01-29T00:00:00,54,54,0,54
ΝΑΞΟΥ,1209,12,0,-6,12,2021-01-29T00:00:00,288,288,0,288
ΝΗΣΩΝ,906,157,0,-30,157,2021-01-29T00:00:00,492,492,0,492
ΝΟΤΙΟΥ ΤΟΜΕΑ ΑΘΗΝΩΝ,907,293,1,6,294,2021-01-29T00:00:00,4089,4089,1,4090
ΞΑΝΘΗΣ,105,55,65,-6,120,2021-01-29T00:00:00,1589,1589,75,1664
ΠΑΡΟΥ,1210,30,0,-12,30,2021-01-29T00:00:00,72,72,0,72
ΠΕΙΡΑΙΩΣ,908,320,444,107,764,2021-01-29T00:00:00,8527,8527,835,9362
ΠΕΛΛΑΣ,204,159,87,8,246,2021-01-29T00:00:00,2291,2291,467,2758
ΠΙΕΡΙΑΣ,205,146,28,-11,174,2021-01-29T00:00:00,1720,1720,301,2021
ΠΡΕΒΕΖΑΣ,404,5,73,24,78,2021-01-29T00:00:00,847,847,119,966
ΡΕΘΥΜΝΟΥ,1303,92,48,3,140,2021-01-29T00:00:00,1707,1707,48,1755
ΡΟΔΟΠΗΣ,106,48,48,0,96,2021-01-29T00:00:00,1215,1215,48,1263
ΡΟΔΟΥ,1211,137,0,-7,137,2021-01-29T00:00:00,1758,1758,0,1758
ΣΑΜΟΥ,1104,41,1,12,42,2021-01-29T00:00:00,633,633,3,636
ΣΕΡΡΩΝ,206,44,94,-30,138,2021-01-29T00:00:00,1971,1971,94,2065
ΣΠΟΡΑΔΩΝ,504,42,0,0,42,2021-01-29T00:00:00,84,84,0,84
ΣΥΡΟΥ,1212,36,0,6,36,2021-01-29T00:00:00,598,598,0,598
ΤΗΝΟΥ,1213,48,0,2,48,2021-01-29T00:00:00,94,94,0,94
ΤΡΙΚΑΛΩΝ,505,90,108,-7,198,2021-01-29T00:00:00,2406,2406,487,2893
ΦΘΙΩΤΙΔΑΣ,804,81,99,18,180,2021-01-29T00:00:00,2395,2395,144,2539
ΦΛΩΡΙΝΑΣ,304,40,50,12,90,2021-01-29T00:00:00,1076,1076,50,1126
ΦΩΚΙΔΑΣ,805,3,45,6,48,2021-01-29T00:00:00,603,603,45,648
ΧΑΛΚΙΔΙΚΗΣ,207,78,48,18,126,2021-01-29T00:00:00,1320,1320,51,1371
ΧΑΝΙΩΝ,1304,206,179,31,385,2021-01-29T00:00:00,3670,3670,754,4424
ΧΙΟΥ,1105,60,0,12,60,2021-01-29T00:00:00,791,791,0,791
ΑΙΤΩΛΟΑΚΑΡΝΑΝΙΑΣ,701,98,88,6,186,2021-01-30T00:00:00,2084,2084,398,2482
ΑΝΑΤΟΛΙΚΗΣ ΑΤΤΙΚΗΣ,901,440,3,-17,443,2021-01-30T00:00:00,4683,4683,616,5299
ΑΝΔΡΟΥ,1201,0,0,-53,0,2021-01-30T00:00:00,108,108,0,108
ΑΡΓΟΛΙΔΑΣ,1001,55,86,-20,141,2021-01-30T00:00:00,1803,1803,197,2000
ΑΡΚΑΔΙΑΣ,1002,62,141,52,203,2021-01-30T00:00:00,1833,1833,302,2135
ΑΡΤΑΣ,401,69,81,-6,150,2021-01-30T00:00:00,1865,1865,353,2218
ΑΧΑΪΑΣ,702,427,100,73,527,2021-01-30T00:00:00,6375,6375,1622,7997
ΒΟΙΩΤΙΑΣ,801,86,88,24,174,2021-01-30T00:00:00,1791,1791,183,1974
ΒΟΡΕΙΟΥ ΤΟΜΕΑ ΑΘΗΝΩΝ,902,948,118,-1100,1066,2021-01-30T00:00:00,30718,30718,3490,34208
ΓΡΕΒΕΝΩΝ,301,6,42,-6,48,2021-01-30T00:00:00,682,682,87,769
ΔΡΑΜΑΣ,101,49,95,0,144,2021-01-30T00:00:00,1871,1871,188,2059
ΔΥΤΙΚΗΣ ΑΤΤΙΚΗΣ,903,212,3,59,215,2021-01-30T00:00:00,2225,2225,418,2643
ΔΥΤΙΚΟΥ ΤΟΜΕΑ ΑΘΗΝΩΝ,904,501,435,-4,936,2021-01-30T00:00:00,9085,9085,1696,10781
ΕΒΡΟΥ,102,91,142,17,233,2021-01-30T00:00:00,3766,3766,235,4001
ΕΥΒΟΙΑΣ,802,289,95,7,384,2021-01-30T00:00:00,4001,4001,301,4302
ΕΥΡΥΤΑΝΙΑΣ,803,5,37,-6,42,2021-01-30T00:00:00,451,451,84,535
ΖΑΚΥΝΘΟΥ,601,66,0,0,66,2021-01-30T00:00:00,1005,1005,0,1005
ΗΛΕΙΑΣ,703,145,128,42,273,2021-01-30T00:00:00,2438,2438,321,2759
ΗΜΑΘΙΑΣ,201,86,100,-18,186,2021-01-30T00:00:00,2314,2314,390,2704
ΗΡΑΚΛΕΙΟΥ,1301,247,215,42,462,2021-01-30T00:00:00,7090,7090,919,8009
ΘΑΣΟΥ,103,42,0,-7,42,2021-01-30T00:00:00,132,132,0,132
ΘΕΣΠΡΩΤΙΑΣ,402,42,54,0,96,2021-01-30T00:00:00,1271,1271,175,1446
ΘΕΣΣΑΛΟΝΙΚΗΣ,202,1119,697,-96,1816,2021-01-30T00:00:00,25337,25337,5453,30790
ΘΗΡΑΣ,1202,24,0,12,24,2021-01-30T00:00:00,245,245,0,245
ΙΘΑΚΗΣ,602,0,0,0,0,2021-01-30T00:00:00,0,0,0,0
ΙΚΑΡΙΑΣ,1101,48,0,36,48,2021-01-30T00:00:00,284,284,1,285
ΙΩΑΝΝΙΝΩΝ,403,176,258,96,434,2021-01-30T00:00:00,5425,5425,1521,6946
ΚΑΒΑΛΑΣ,104,82,92,-12,174,2021-01-30T00:00:00,2552,2552,187,2739
ΚΑΛΥΜΝΟΥ,1203,54,0,31,54,2021-01-30T00:00:00,576,576,1,577
ΚΑΡΔΙΤΣΑΣ,501,214,14,-16,228,2021-01-30T00:00:00,2443,2443,534,2977
ΚΑΡΠΑΘΟΥ,1204,12,0,-6,12,2021-01-30T00:00:00,195,195,0,195
ΚΑΣΤΟΡΙΑΣ,302,48,48,-20,96,2021-01-30T00:00:00,1212,1212,95,1307
ΚΕΑΣ-ΚΥΘΝΟΥ,1205,0,0,0,0,2021-01-30T00:00:00,0,0,0,0
ΚΕΝΤΡΙΚΟΥ ΤΟΜΕΑ ΑΘΗΝΩΝ,905,1676,1113,-744,2789,2021-01-30T00:00:00,35973,35973,10944,46917
ΚΕΡΚΥΡΑΣ,603,96,0,12,96,2021-01-30T00:00:00,2162,2162,0,2162
ΚΕΦΑΛΛΗΝΙΑΣ,604,125,0,28,125,2021-01-30T00:00:00,1368,1368,0,1368
ΚΙΛΚΙΣ,203,120,54,60,174,2021-01-30T00:00:00,1771,1771,149,1920
ΚΟΖΑΝΗΣ,303,147,50,-1,197,2021-01-30T00:00:00,2277,2277,494,2771
ΚΟΡΙΝΘΙΑΣ,1003,102,54,12,156,2021-01-30T00:00:00,1498,1498,272,1770
ΚΩ,1206,72,0,36,72,2021-01-30T00:00:00,701,701,1,702
ΛΑΚΩΝΙΑΣ,1004,80,116,57,196,2021-01-30T00:00:00,1841,1841,348,2189
ΛΑΡΙΣΑΣ,502,263,54,-7,317,2021-01-30T00:00:00,4517,4517,1460,5977
ΛΑΣΙΘΙΟΥ,1302,156,115,-2,271,2021-01-30T00:00:00,2895,2895,266,3161
ΛΕΣΒΟΥ,1102,144,0,24,144,2021-01-30T00:00:00,1855,1855,0,1855
ΛΕΥΚΑΔΑΣ,605,48,0,0,48,2021-01-30T00:00:00,735,735,0,735
ΛΗΜΝΟΥ,1103,48,0,18,48,2021-01-30T00:00:00,568,568,0,568
ΜΑΓΝΗΣΙΑΣ,503,240,91,121,331,2021-01-30T00:00:00,2554,2554,136,2690
ΜΕΣΣΗΝΙΑΣ,1005,112,174,16,286,2021-01-30T00:00:00,2910,2910,364,3274
ΜΗΛΟΥ,1207,6,0,0,6,2021-01-30T00:00:00,24,24,0,24
ΜΥΚΟΝΟΥ,1208,36,0,18,36,2021-01-30T00:00:00,90,90,0,90
ΝΑΞΟΥ,1209,36,0,24,36,2021-01-30T00:00:00,324,324,0,324
ΝΗΣΩΝ,906,210,0,53,210,2021-01-30T00:00:00,702,702,0,702
ΝΟΤΙΟΥ ΤΟΜΕΑ ΑΘΗΝΩΝ,907,288,0,-6,288,2021-01-30T00:00:00,4377,4377,1,4378
ΞΑΝΘΗΣ,105,60,78,18,138,2021-01-30T00:00:00,1649,1649,153,1802
ΠΑΡΟΥ,1210,36,0,6,36,2021-01-30T00:00:00,108,108,0,108
ΠΕΙΡΑΙΩΣ,908,378,420,34,798,2021-01-30T00:00:00,8905,8905,1255,10160
ΠΕΛΛΑΣ,204,214,20,-12,234,2021-01-30T00:00:00,2505,2505,487,2992
ΠΙΕΡΙΑΣ,205,158,16,0,174,2021-01-30T00:00:00,1878,1878,317,2195
ΠΡΕΒΕΖΑΣ,404,0,72,-6,72,2021-01-30T00:00:00,847,847,191,1038
ΡΕΘΥΜΝΟΥ,1303,133,47,40,180,2021-01-30T00:00:00,1840,1840,95,1935
ΡΟΔΟΠΗΣ,106,50,46,0,96,2021-01-30T00:00:00,1265,1265,94,1359
ΡΟΔΟΥ,1211,102,0,-35,102,2021-01-30T00:00:00,1860,1860,0,1860
ΣΑΜΟΥ,1104,54,0,12,54,2021-01-30T00:00:00,687,687,3,690
ΣΕΡΡΩΝ,206,51,93,6,144,2021-01-30T00:00:00,2022,2022,187,2209
ΣΠΟΡΑΔΩΝ,504,48,0,6,48,2021-01-30T00:00:00,132,132,0,132
ΣΥΡΟΥ,1212,30,0,-6,30,2021-01-30T00:00:00,628,628,0,628
ΤΗΝΟΥ,1213,37,0,-11,37,2021-01-30T00:00:00,131,131,0,131
ΤΡΙΚΑΛΩΝ,505,136,50,-12,186,2021-01-30T00:00:00,2542,2542,537,3079
ΦΘΙΩΤΙΔΑΣ,804,92,88,0,180,2021-01-30T00:00:00,2487,2487,232,2719
ΦΛΩΡΙΝΑΣ,304,38,58,6,96,2021-01-30T00:00:00,1114,1114,108,1222
ΦΩΚΙΔΑΣ,805,5,43,0,48,2021-01-30T00:00:00,608,608,88,696
ΧΑΛΚΙΔΙΚΗΣ,207,67,47,-12,114,2021-01-30T00:00:00,1387,1387,98,1485
ΧΑΝΙΩΝ,1304,287,87,-11,374,2021-01-30T00:00:00,3957,3957,841,4798
ΧΙΟΥ,1105,54,0,-6,54,2021-01-30T00:00:00,845,845,0,845
ΑΙΤΩΛΟΑΚΑΡΝΑΝΙΑΣ,701,112,140,66,252,2021-02-01T00:00:00,2196,2196,538,2734
ΑΝΑΤΟΛΙΚΗΣ ΑΤΤΙΚΗΣ,901,525,0,82,525,2021-02-01T00:00:00,5208,5208,616,5824
ΑΝΔΡΟΥ,1201,54,0,54,54,2021-02-01T00:00:00,162,162,0,162
ΑΡΓΟΛΙΔΑΣ,1001,110,59,28,169,2021-02-01T00:00:00,1913,1913,256,2169
ΑΡΚΑΔΙΑΣ,1002,62,124,-17,186,2021-02-01T00:00:00,1895,1895,426,2321
ΑΡΤΑΣ,401,115,77,42,192,2021-02-01T00:00:00,1980,1980,430,2410
ΑΧΑΪΑΣ,702,619,16,108,635,2021-02-01T00:00:00,6994,6994,1638,8632
ΒΟΙΩΤΙΑΣ,801,111,98,35,209,2021-02-01T00:00:00,1902,1902,281,2183
ΒΟΡΕΙΟΥ ΤΟΜΕΑ ΑΘΗΝΩΝ,902,1372,1304,1610,2676,2021-02-01T00:00:00,32090,32090,4794,36884
ΓΡΕΒΕΝΩΝ,301,6,48,6,54,2021-02-01T00:00:00,688,688,135,823
ΔΡΑΜΑΣ,101,90,96,42,186,2021-02-01T00:00:00,1961,1961,284,2245
ΔΥΤΙΚΗΣ ΑΤΤΙΚΗΣ,903,318,23,126,341,2021-02-01T00:00:00,2543,2543,441,2984
ΔΥΤΙΚΟΥ ΤΟΜΕΑ ΑΘΗΝΩΝ,904,645,484,193,1129,2021-02-01T00:00:00,9730,9730,2180,11910
ΕΒΡΟΥ,102,84,198,49,282,2021-02-01T00:00:00,3850,3850,433,4283
ΕΥΒΟΙΑΣ,802,346,124,86,470,2021-02-01T00:00:00,4347,4347,425,4772
ΕΥΡΥΤΑΝΙΑΣ,803,19,35,12,54,2021-02-01T00:00:00,470,470,119,589
ΖΑΚΥΝΘΟΥ,601,89,0,23,89,2021-02-01T00:00:00,1094,1094,0,1094
ΗΛΕΙΑΣ,703,139,136,2,275,2021-02-01T00:00:00,2577,2577,457,3034
ΗΜΑΘΙΑΣ,201,116,106,36,222,2021-02-01T00:00:00,2430,2430,496,2926
ΗΡΑΚΛΕΙΟΥ,1301,295,237,70,532,2021-02-01T00:00:00,7385,7385,1156,8541
ΘΑΣΟΥ,103,47,0,5,47,2021-02-01T00:00:00,179,179,0,179
ΘΕΣΠΡΩΤΙΑΣ,402,57,45,6,102,2021-02-01T00:00:00,1328,1328,220,1548
ΘΕΣΣΑΛΟΝΙΚΗΣ,202,1539,648,371,2187,2021-02-01T00:00:00,26876,26876,6101,32977
ΘΗΡΑΣ,1202,31,5,12,36,2021-02-01T00:00:00,276,276,5,281
ΙΘΑΚΗΣ,602,0,0,0,0,2021-02-01T00:00:00,0,0,0,0
ΙΚΑΡΙΑΣ,1101,35,1,-12,36,2021-02-01T00:00:00,319,319,2,321
ΙΩΑΝΝΙΝΩΝ,403,220,295,81,515,2021-02-01T00:00:00,5645,5645,1816,7461
ΚΑΒΑΛΑΣ,104,124,116,66,240,2021-02-01T00:00:00,2676,2676,303,2979
ΚΑΛΥΜΝΟΥ,1203,36,0,-18,36,2021-02-01T00:00:00,612,612,1,613
ΚΑΡΔΙΤΣΑΣ,501,252,0,24,252,2021-02-01T00:00:00,2695,2695,534,3229
ΚΑΡΠΑΘΟΥ,1204,30,0,18,30,2021-02-01T00:00:00,225,225,0,225
ΚΑΣΤΟΡΙΑΣ,302,59,48,11,107,2021-02-01T00:00:00,1271,1271,143,1414
ΚΕΑΣ-ΚΥΘΝΟΥ,1205,0,0,0,0,2021-02-01T00:00:00,0,0,0,0
ΚΕΝΤΡΙΚΟΥ ΤΟΜΕΑ ΑΘΗΝΩΝ,905,1813,1341,365,3154,2021-02-01T00:00:00,37786,37786,12285,50071
ΚΕΡΚΥΡΑΣ,603,121,65,90,186,2021-02-01T00:00:00,2283,2283,65,2348
ΚΕΦΑΛΛΗΝΙΑΣ,604,110,20,5,130,2021-02-01T00:00:00,1478,1478,20,1498
ΚΙΛΚΙΣ,203,147,63,36,210,2021-02-01T00:00:00,1918,1918,212,2130
ΚΟΖΑΝΗΣ,303,119,95,17,214,2021-02-01T00:00:00,2396,2396,589,2985
ΚΟΡΙΝΘΙΑΣ,1003,164,4,12,168,2021-02-01T00:00:00,1662,1662,276,1938
ΚΩ,1206,137,0,65,137,2021-02-01T00:00:00,838,838,1,839
ΛΑΚΩΝΙΑΣ,1004,199,14,17,213,2021-02-01T00:00:00,2040,2040,362,2402
ΛΑΡΙΣΑΣ,502,311,86,80,397,2021-02-01T00:00:00,4828,4828,1546,6374
ΛΑΣΙΘΙΟΥ,1302,220,86,35,306,2021-02-01T00:00:00,3115,3115,352,3467
ΛΕΣΒΟΥ,1102,167,0,23,167,2021-02-01T00:00:00,2022,2022,0,2022
ΛΕΥΚΑΔΑΣ,605,24,30,6,54,2021-02-01T00:00:00,759,759,30,789
ΛΗΜΝΟΥ,1103,60,0,12,60,2021-02-01T00:00:00,628,628,0,628
ΜΑΓΝΗΣΙΑΣ,503,264,95,28,359,2021-02-01T00:00:00,2818,2818,231,3049
ΜΕΣΣΗΝΙΑΣ,1005,200,133,47,333,2021-02-01T00:00:00,3110,3110,497,3607
ΜΗΛΟΥ,1207,31,0,25,31,2021-02-01T00:00:00,55,55,0,55
ΜΥΚΟΝΟΥ,1208,36,0,0,36,2021-02-01T00:00:00,126,126,0,126
ΝΑΞΟΥ,1209,48,0,12,48,2021-02-01T00:00:00,372,372,0,372
ΝΗΣΩΝ,906,209,0,-1,209,2021-02-01T00:00:00,911,911,0,911
ΝΟΤΙΟΥ ΤΟΜΕΑ ΑΘΗΝΩΝ,907,288,28,28,316,2021-02-01T00:00:00,4665,4665,29,4694
ΞΑΝΘΗΣ,105,17,145,24,162,2021-02-01T00:00:00,1666,1666,298,1964
ΠΑΡΟΥ,1210,48,0,12,48,2021-02-01T00:00:00,156,156,0,156
ΠΕΙΡΑΙΩΣ,908,553,286,41,839,2021-02-01T00:00:00,9458,9458,1541,10999
ΠΕΛΛΑΣ,204,272,34,72,306,2021-02-01T00:00:00,2777,2777,521,3298
ΠΙΕΡΙΑΣ,205,179,31,36,210,2021-02-01T00:00:00,2057,2057,348,2405
ΠΡΕΒΕΖΑΣ,404,3,75,6,78,2021-02-01T00:00:00,850,850,266,1116
ΡΕΘΥΜΝΟΥ,1303,146,46,12,192,2021-02-01T00:00:00,1986,1986,141,2127
ΡΟΔΟΠΗΣ,106,59,49,12,108,2021-02-01T00:00:00,1324,1324,143,1467
ΡΟΔΟΥ,1211,107,0,5,107,2021-02-01T00:00:00,1967,1967,0,1967
ΣΑΜΟΥ,1104,54,0,0,54,2021-02-01T00:00:00,741,741,3,744
ΣΕΡΡΩΝ,206,80,94,30,174,2021-02-01T00:00:00,2102,2102,281,2383
ΣΠΟΡΑΔΩΝ,504,54,0,6,54,2021-02-01T00:00:00,186,186,0,186
ΣΥΡΟΥ,1212,59,1,30,60,2021-02-01T00:00:00,687,687,1,688
ΤΗΝΟΥ,1213,47,1,11,48,2021-02-01T00:00:00,178,178,1,179
ΤΡΙΚΑΛΩΝ,505,138,79,31,217,2021-02-01T00:00:00,2680,2680,616,3296
ΦΘΙΩΤΙΔΑΣ,804,125,97,42,222,2021-02-01T00:00:00,2612,2612,329,2941
ΦΛΩΡΙΝΑΣ,304,55,71,30,126,2021-02-01T00:00:00,1169,1169,179,1348
ΦΩΚΙΔΑΣ,805,39,15,6,54,2021-02-01T00:00:00,647,647,103,750
ΧΑΛΚΙΔΙΚΗΣ,207,98,58,42,156,2021-02-01T00:00:00,1485,1485,156,1641
ΧΑΝΙΩΝ,1304,340,73,39,413,2021-02-01T00:00:00,4297,4297,914,5211
ΧΙΟΥ,1105,54,0,0,54,2021-02-01T00:00:00,899,899,0,899
ΑΙΤΩΛΟΑΚΑΡΝΑΝΙΑΣ,701,121,119,-12,240,2021-02-02T00:00:00,2317,2317,657,2974
ΑΝΑΤΟΛΙΚΗΣ ΑΤΤΙΚΗΣ,901,525,0,0,525,2021-02-02T00:00:00,5733,5733,616,6349
ΑΝΔΡΟΥ,1201,42,0,-12,42,2021-02-02T00:00:00,204,204,0,204
ΑΡΓΟΛΙΔΑΣ,1001,165,3,-1,168,2021-02-02T00:00:00,2078,2078,259,2337
ΑΡΚΑΔΙΑΣ,1002,109,47,-30,156,2021-02-02T00:00:00,2004,2004,473,2477
ΑΡΤΑΣ,401,109,76,-7,185,2021-02-02T00:00:00,2089,2089,506,2595
ΑΧΑΪΑΣ,702,433,103,-99,536,2021-02-02T00:00:00,7427,7427,1741,9168
ΒΟΙΩΤΙΑΣ,801,89,69,-51,158,2021-02-02T00:00:00,1991,1991,350,2341
ΒΟΡΕΙΟΥ ΤΟΜΕΑ ΑΘΗΝΩΝ,902,1167,1273,-236,2440,2021-02-02T00:00:00,33257,33257,6067,39324
ΓΡΕΒΕΝΩΝ,301,5,49,0,54,2021-02-02T00:00:00,693,693,184,877
ΔΡΑΜΑΣ,101,64,86,-36,150,2021-02-02T00:00:00,2025,2025,370,2395
ΔΥΤΙΚΗΣ ΑΤΤΙΚΗΣ,903,190,25,-126,215,2021-02-02T00:00:00,2733,2733,466,3199
ΔΥΤΙΚΟΥ ΤΟΜΕΑ ΑΘΗΝΩΝ,904,714,106,-309,820,2021-02-02T00:00:00,10444,10444,2286,12730
ΕΒΡΟΥ,102,87,243,48,330,2021-02-02T00:00:00,3937,3937,676,4613
ΕΥΒΟΙΑΣ,802,218,138,-114,356,2021-02-02T00:00:00,4565,4565,563,5128
ΕΥΡΥΤΑΝΙΑΣ,803,24,24,-6,48,2021-02-02T00:00:00,494,494,143,637
ΖΑΚΥΝΘΟΥ,601,55,48,14,103,2021-02-02T00:00:00,1149,1149,48,1197
ΗΛΕΙΑΣ,703,192,46,-37,238,2021-02-02T00:00:00,2769,2769,503,3272
ΗΜΑΘΙΑΣ,201,159,69,6,228,2021-02-02T00:00:00,2589,2589,565,3154
ΗΡΑΚΛΕΙΟΥ,1301,305,241,14,546,2021-02-02T00:00:00,7690,7690,1397,9087
ΘΑΣΟΥ,103,48,0,1,48,2021-02-02T00:00:00,227,227,0,227
ΘΕΣΠΡΩΤΙΑΣ,402,101,0,-1,101,2021-02-02T00:00:00,1429,1429,220,1649
ΘΕΣΣΑΛΟΝΙΚΗΣ,202,1602,829,244,2431,2021-02-02T00:00:00,28478,28478,6930,35408
ΘΗΡΑΣ,1202,11,13,-12,24,2021-02-02T00:00:00,287,287,18,305
ΙΘΑΚΗΣ,602,0,0,0,0,2021-02-02T00:00:00,0,0,0,0
ΙΚΑΡΙΑΣ,1101,8,22,-6,30,2021-02-02T00:00:00,327,327,24,351
ΙΩΑΝΝΙΝΩΝ,403,135,255,-125,390,2021-02-02T00:00:00,5780,5780,2071,7851
ΚΑΒΑΛΑΣ,104,118,122,0,240,2021-02-02T00:00:00,2794,2794,425,3219
ΚΑΛΥΜΝΟΥ,1203,44,10,18,54,2021-02-02T00:00:00,656,656,11,667
ΚΑΡΔΙΤΣΑΣ,501,252,0,0,252,2021-02-02T00:00:00,2947,2947,534,3481
ΚΑΡΠΑΘΟΥ,1204,8,10,-12,18,2021-02-02T00:00:00,233,233,10,243
ΚΑΣΤΟΡΙΑΣ,302,61,48,2,109,2021-02-02T00:00:00,1332,1332,191,1523
ΚΕΑΣ-ΚΥΘΝΟΥ,1205,0,0,0,0,2021-02-02T00:00:00,0,0,0,0
ΚΕΝΤΡΙΚΟΥ ΤΟΜΕΑ ΑΘΗΝΩΝ,905,2249,1553,648,3802,2021-02-02T00:00:00,40035,40035,13838,53873
ΚΕΡΚΥΡΑΣ,603,107,97,18,204,2021-02-02T00:00:00,2390,2390,162,2552
ΚΕΦΑΛΛΗΝΙΑΣ,604,31,90,-9,121,2021-02-02T00:00:00,1509,1509,110,1619
ΚΙΛΚΙΣ,203,126,43,-41,169,2021-02-02T00:00:00,2044,2044,255,2299
ΚΟΖΑΝΗΣ,303,172,38,-4,210,2021-02-02T00:00:00,2568,2568,627,3195
ΚΟΡΙΝΘΙΑΣ,1003,146,10,-12,156,2021-02-02T00:00:00,1808,1808,286,2094
ΚΩ,1206,66,0,-71,66,2021-02-02T00:00:00,904,904,1,905
ΛΑΚΩΝΙΑΣ,1004,94,2,-117,96,2021-02-02T00:00:00,2134,2134,364,2498
ΛΑΡΙΣΑΣ,502,319,114,36,433,2021-02-02T00:00:00,5147,5147,1660,6807
ΛΑΣΙΘΙΟΥ,1302,223,50,-33,273,2021-02-02T00:00:00,3338,3338,402,3740
ΛΕΣΒΟΥ,1102,88,68,-11,156,2021-02-02T00:00:00,2110,2110,68,2178
ΛΕΥΚΑΔΑΣ,605,5,49,0,54,2021-02-02T00:00:00,764,764,79,843
ΛΗΜΝΟΥ,1103,17,43,0,60,2021-02-02T00:00:00,645,645,43,688
ΜΑΓΝΗΣΙΑΣ,503,247,98,-14,345,2021-02-02T00:00:00,3065,3065,329,3394
ΜΕΣΣΗΝΙΑΣ,1005,225,53,-55,278,2021-02-02T00:00:00,3335,3335,550,3885
ΜΗΛΟΥ,1207,24,0,-7,24,2021-02-02T00:00:00,79,79,0,79
ΜΥΚΟΝΟΥ,1208,18,0,-18,18,2021-02-02T00:00:00,144,144,0,144
ΝΑΞΟΥ,1209,14,34,0,48,2021-02-02T00:00:00,386,386,34,420
ΝΗΣΩΝ,906,183,25,-1,208,2021-02-02T00:00:00,1094,1094,25,1119
ΝΟΤΙΟΥ ΤΟΜΕΑ ΑΘΗΝΩΝ,907,306,88,78,394,2021-02-02T00:00:00,4971,4971,117,5088
ΞΑΝΘΗΣ,105,62,118,18,180,2021-02-02T00:00:00,1728,1728,416,2144
ΠΑΡΟΥ,1210,42,0,-6,42,2021-02-02T00:00:00,198,198,0,198
ΠΕΙΡΑΙΩΣ,908,619,247,27,866,2021-02-02T00:00:00,10077,10077,1788,11865
ΠΕΛΛΑΣ,204,294,0,-12,294,2021-02-02T00:00:00,3071,3071,521,3592
ΠΙΕΡΙΑΣ,205,232,21,43,253,2021-02-02T00:00:00,2289,2289,369,2658
ΠΡΕΒΕΖΑΣ,404,7,47,-24,54,2021-02-02T00:00:00,857,857,313,1170
ΡΕΘΥΜΝΟΥ,1303,132,60,0,192,2021-02-02T00:00:00,2118,2118,201,2319
ΡΟΔΟΠΗΣ,106,61,47,0,108,2021-02-02T00:00:00,1385,1385,190,1575
ΡΟΔΟΥ,1211,1,0,-106,1,2021-02-02T00:00:00,1968,1968,0,1968
ΣΑΜΟΥ,1104,6,60,12,66,2021-02-02T00:00:00,747,747,63,810
ΣΕΡΡΩΝ,206,60,96,-18,156,2021-02-02T00:00:00,2162,2162,377,2539
ΣΠΟΡΑΔΩΝ,504,12,0,-42,12,2021-02-02T00:00:00,198,198,0,198
ΣΥΡΟΥ,1212,7,44,-9,51,2021-02-02T00:00:00,694,694,45,739
ΤΗΝΟΥ,1213,36,0,-12,36,2021-02-02T00:00:00,214,214,1,215
ΤΡΙΚΑΛΩΝ,505,200,2,-15,202,2021-02-02T00:00:00,2880,2880,618,3498
ΦΘΙΩΤΙΔΑΣ,804,86,93,-43,179,2021-02-02T00:00:00,2698,2698,422,3120
ΦΛΩΡΙΝΑΣ,304,54,48,-24,102,2021-02-02T00:00:00,1223,1223,227,1450
ΦΩΚΙΔΑΣ,805,58,0,4,58,2021-02-02T00:00:00,705,705,103,808
ΧΑΛΚΙΔΙΚΗΣ,207,103,42,-11,145,2021-02-02T00:00:00,1588,1588,198,1786
ΧΑΝΙΩΝ,1304,396,2,-15,398,2021-02-02T00:00:00,4693,4693,916,5609
ΧΙΟΥ,1105,3,63,12,66,2021-02-02T00:00:00,902,902,63,965
ΑΙΤΩΛΟΑΚΑΡΝΑΝΙΑΣ,701,186,30,-24,216,2021-02-03T00:00:00,2503,2503,687,3190
ΑΝΑΤΟΛΙΚΗΣ ΑΤΤΙΚΗΣ,901,509,1,-15,510,2021-02-03T00:00:00,6242,6242,617,6859
ΑΝΔΡΟΥ,1201,35,0,-7,35,2021-02-03T00:00:00,239,239,0,239
ΑΡΓΟΛΙΔΑΣ,1001,166,1,-1,167,2021-02-03T00:00:00,2244,2244,260,2504
ΑΡΚΑΔΙΑΣ,1002,151,10,5,161,2021-02-03T00:00:00,2155,2155,483,2638
ΑΡΤΑΣ,401,151,36,2,187,2021-02-03T00:00:00,2240,2240,542,2782
ΑΧΑΪΑΣ,702,370,190,24,560,2021-02-03T00:00:00,7797,7797,1931,9728
ΒΟΙΩΤΙΑΣ,801,120,1,-37,121,2021-02-03T00:00:00,2111,2111,351,2462
ΒΟΡΕΙΟΥ ΤΟΜΕΑ ΑΘΗΝΩΝ,902,1328,1941,829,3269,2021-02-03T00:00:00,34585,34585,8008,42593
ΓΡΕΒΕΝΩΝ,301,45,9,0,54,2021-02-03T00:00:00,738,738,193,931
ΔΡΑΜΑΣ,101,150,0,0,150,2021-02-03T00:00:00,2175,2175,370,2545
ΔΥΤΙΚΗΣ ΑΤΤΙΚΗΣ,903,63,34,-118,97,2021-02-03T00:00:00,2796,2796,500,3296
ΔΥΤΙΚΟΥ ΤΟΜΕΑ ΑΘΗΝΩΝ,904,606,84,-130,690,2021-02-03T00:00:00,11050,11050,2370,13420
ΕΒΡΟΥ,102,156,150,-24,306,2021-02-03T00:00:00,4093,4093,826,4919
ΕΥΒΟΙΑΣ,802,301,2,-53,303,2021-02-03T00:00:00,4866,4866,565,5431
ΕΥΡΥΤΑΝΙΑΣ,803,42,0,-6,42,2021-02-03T00:00:00,536,536,143,679
ΖΑΚΥΝΘΟΥ,601,5,49,-49,54,2021-02-03T00:00:00,1154,1154,97,1251
ΗΛΕΙΑΣ,703,218,0,-20,218,2021-02-03T00:00:00,2987,2987,503,3490
ΗΜΑΘΙΑΣ,201,201,15,-12,216,2021-02-03T00:00:00,2790,2790,580,3370
ΗΡΑΚΛΕΙΟΥ,1301,286,241,-19,527,2021-02-03T00:00:00,7976,7976,1638,9614
ΘΑΣΟΥ,103,39,9,0,48,2021-02-03T00:00:00,266,266,9,275
ΘΕΣΠΡΩΤΙΑΣ,402,111,1,11,112,2021-02-03T00:00:00,1540,1540,221,1761
ΘΕΣΣΑΛΟΝΙΚΗΣ,202,1601,1165,335,2766,2021-02-03T00:00:00,30079,30079,8095,38174
ΘΗΡΑΣ,1202,11,1,-12,12,2021-02-03T00:00:00,298,298,19,317
ΙΘΑΚΗΣ,602,0,0,0,0,2021-02-03T00:00:00,0,0,0,0
ΙΚΑΡΙΑΣ,1101,24,6,0,30,2021-02-03T00:00:00,351,351,30,381
ΙΩΑΝΝΙΝΩΝ,403,260,189,59,449,2021-02-03T00:00:00,6040,6040,2260,8300
ΚΑΒΑΛΑΣ,104,115,131,6,246,2021-02-03T00:00:00,2909,2909,556,3465
ΚΑΛΥΜΝΟΥ,1203,8,86,40,94,2021-02-03T00:00:00,664,664,97,761
ΚΑΡΔΙΤΣΑΣ,501,245,1,-6,246,2021-02-03T00:00:00,3192,3192,535,3727
ΚΑΡΠΑΘΟΥ,1204,13,5,0,18,2021-02-03T00:00:00,246,246,15,261
ΚΑΣΤΟΡΙΑΣ,302,50,56,-3,106,2021-02-03T00:00:00,1382,1382,247,1629
ΚΕΑΣ-ΚΥΘΝΟΥ,1205,0,0,0,0,2021-02-03T00:00:00,0,0,0,0
ΚΕΝΤΡΙΚΟΥ ΤΟΜΕΑ ΑΘΗΝΩΝ,905,2471,1371,40,3842,2021-02-03T00:00:00,42506,42506,15209,57715
ΚΕΡΚΥΡΑΣ,603,115,34,-55,149,2021-02-03T00:00:00,2505,2505,196,2701
ΚΕΦΑΛΛΗΝΙΑΣ,604,20,63,-38,83,2021-02-03T00:00:00,1529,1529,173,1702
ΚΙΛΚΙΣ,203,101,49,-19,150,2021-02-03T00:00:00,2145,2145,304,2449
ΚΟΖΑΝΗΣ,303,190,14,-6,204,2021-02-03T00:00:00,2758,2758,641,3399
ΚΟΡΙΝΘΙΑΣ,1003,152,10,6,162,2021-02-03T00:00:00,1960,1960,296,2256
ΚΩ,1206,4,45,-17,49,2021-02-03T00:00:00,908,908,46,954
ΛΑΚΩΝΙΑΣ,1004,124,1,29,125,2021-02-03T00:00:00,2258,2258,365,2623
ΛΑΡΙΣΑΣ,502,361,30,-42,391,2021-02-03T00:00:00,5508,5508,1690,7198
ΛΑΣΙΘΙΟΥ,1302,149,48,-76,197,2021-02-03T00:00:00,3487,3487,450,3937
ΛΕΣΒΟΥ,1102,73,83,0,156,2021-02-03T00:00:00,2183,2183,151,2334
ΛΕΥΚΑΔΑΣ,605,39,15,0,54,2021-02-03T00:00:00,803,803,94,897
ΛΗΜΝΟΥ,1103,4,62,6,66,2021-02-03T00:00:00,649,649,105,754
ΜΑΓΝΗΣΙΑΣ,503,162,97,-86,259,2021-02-03T00:00:00,3227,3227,426,3653
ΜΕΣΣΗΝΙΑΣ,1005,251,1,-26,252,2021-02-03T00:00:00,3586,3586,551,4137
ΜΗΛΟΥ,1207,22,0,-2,22,2021-02-03T00:00:00,101,101,0,101
ΜΥΚΟΝΟΥ,1208,0,0,-18,0,2021-02-03T00:00:00,144,144,0,144
ΝΑΞΟΥ,1209,24,0,-24,24,2021-02-03T00:00:00,410,410,34,444
ΝΗΣΩΝ,906,121,0,-87,121,2021-02-03T00:00:00,1215,1215,25,1240
ΝΟΤΙΟΥ ΤΟΜΕΑ ΑΘΗΝΩΝ,907,300,276,182,576,2021-02-03T00:00:00,5271,5271,393,5664
ΞΑΝΘΗΣ,105,67,77,-36,144,2021-02-03T00:00:00,1795,1795,493,2288
ΠΑΡΟΥ,1210,30,0,-12,30,2021-02-03T00:00:00,228,228,0,228
ΠΕΙΡΑΙΩΣ,908,621,333,88,954,2021-02-03T00:00:00,10698,10698,2121,12819
ΠΕΛΛΑΣ,204,304,1,11,305,2021-02-03T00:00:00,3375,3375,522,3897
ΠΙΕΡΙΑΣ,205,199,10,-44,209,2021-02-03T00:00:00,2488,2488,379,2867
ΠΡΕΒΕΖΑΣ,404,49,5,0,54,2021-02-03T00:00:00,906,906,318,1224
ΡΕΘΥΜΝΟΥ,1303,69,81,-42,150,2021-02-03T00:00:00,2187,2187,282,2469
ΡΟΔΟΠΗΣ,106,49,71,12,120,2021-02-03T00:00:00,1434,1434,261,1695
ΡΟΔΟΥ,1211,11,209,219,220,2021-02-03T00:00:00,1979,1979,209,2188
ΣΑΜΟΥ,1104,4,50,-12,54,2021-02-03T00:00:00,751,751,113,864
ΣΕΡΡΩΝ,206,56,161,61,217,2021-02-03T00:00:00,2218,2218,538,2756
ΣΠΟΡΑΔΩΝ,504,3,3,-6,6,2021-02-03T00:00:00,201,201,3,204
ΣΥΡΟΥ,1212,3,51,3,54,2021-02-03T00:00:00,697,697,96,793
ΤΗΝΟΥ,1213,30,0,-6,30,2021-02-03T00:00:00,244,244,1,245
ΤΡΙΚΑΛΩΝ,505,200,15,13,215,2021-02-03T00:00:00,3080,3080,633,3713
ΦΘΙΩΤΙΔΑΣ,804,41,98,-40,139,2021-02-03T00:00:00,2739,2739,520,3259
ΦΛΩΡΙΝΑΣ,304,87,15,0,102,2021-02-03T00:00:00,1310,1310,242,1552
ΦΩΚΙΔΑΣ,805,52,0,-6,52,2021-02-03T00:00:00,757,757,103,860
ΧΑΛΚΙΔΙΚΗΣ,207,67,51,-27,118,2021-02-03T00:00:00,1655,1655,249,1904
ΧΑΝΙΩΝ,1304,363,0,-35,363,2021-02-03T00:00:00,5056,5056,916,5972
ΧΙΟΥ,1105,6,60,0,66,2021-02-03T00:00:00,908,908,123,1031
ΑΙΤΩΛΟΑΚΑΡΝΑΝΙΑΣ,701,292,50,-3,342,2021-03-18T00:00:00,11658,11658,4641,16299
ΑΝΑΤΟΛΙΚΗΣ ΑΤΤΙΚΗΣ,901,749,89,15,838,2021-03-18T00:00:00,25455,25455,10088,35543
ΑΝΔΡΟΥ,1201,0,1,-13,1,2021-03-18T00:00:00,316,316,296,612
ΑΡΓΟΛΙΔΑΣ,1001,180,23,-17,203,2021-03-18T00:00:00,7457,7457,3175,10632
ΑΡΚΑΔΙΑΣ,1002,159,35,-3,194,2021-03-18T00:00:00,7373,7373,3005,10378
ΑΡΤΑΣ,401,133,43,-1,176,2021-03-18T00:00:00,5489,5489,3544,9033
ΑΧΑΪΑΣ,702,618,115,25,733,2021-03-18T00:00:00,21617,21617,10755,32372
ΒΟΙΩΤΙΑΣ,801,174,95,-12,269,2021-03-18T00:00:00,10473,10473,3314,13787
ΒΟΡΕΙΟΥ ΤΟΜΕΑ ΑΘΗΝΩΝ,902,1724,2638,936,4362,2021-03-18T00:00:00,126309,126310,55821,182131
ΓΡΕΒΕΝΩΝ,301,73,30,-12,103,2021-03-18T00:00:00,3013,3013,1430,4443
ΔΡΑΜΑΣ,101,170,73,24,243,2021-03-18T00:00:00,7208,7208,3726,10934
ΔΥΤΙΚΗΣ ΑΤΤΙΚΗΣ,903,88,45,24,133,2021-03-18T00:00:00,8417,8417,3087,11504
ΔΥΤΙΚΟΥ ΤΟΜΕΑ ΑΘΗΝΩΝ,904,1046,272,61,1318,2021-03-18T00:00:00,36713,36713,18565,55278
ΕΒΡΟΥ,102,221,194,-7,415,2021-03-18T00:00:00,13089,13089,6408,19497
ΕΥΒΟΙΑΣ,802,360,133,-2,493,2021-03-18T00:00:00,15644,15644,6811,22455
ΕΥΡΥΤΑΝΙΑΣ,803,26,5,-7,31,2021-03-18T00:00:00,1670,1670,723,2393
ΖΑΚΥΝΘΟΥ,601,46,35,-25,81,2021-03-18T00:00:00,2529,2529,1501,4030
ΗΛΕΙΑΣ,703,266,82,15,348,2021-03-18T00:00:00,9676,9676,4122,13798
ΗΜΑΘΙΑΣ,201,261,103,7,364,2021-03-18T00:00:00,10096,10096,5316,15412
ΗΡΑΚΛΕΙΟΥ,1301,471,278,-35,749,2021-03-18T00:00:00,22153,22153,10962,33115
ΘΑΣΟΥ,103,0,0,-6,0,2021-03-18T00:00:00,442,442,438,880
ΘΕΣΠΡΩΤΙΑΣ,402,114,40,11,154,2021-03-18T00:00:00,5469,5469,2376,7845
ΘΕΣΣΑΛΟΝΙΚΗΣ,202,1832,1733,-176,3565,2021-03-18T00:00:00,103491,103493,49698,153191
ΘΗΡΑΣ,1202,30,0,18,30,2021-03-18T00:00:00,893,893,390,1283
ΙΘΑΚΗΣ,602,0,0,-60,0,2021-03-18T00:00:00,776,776,130,906
ΙΚΑΡΙΑΣ,1101,0,6,0,6,2021-03-18T00:00:00,1441,1441,703,2144
ΙΩΑΝΝΙΝΩΝ,403,313,176,10,489,2021-03-18T00:00:00,15732,15733,9094,24827
ΚΑΒΑΛΑΣ,104,223,139,9,362,2021-03-18T00:00:00,8964,8964,4979,13943
ΚΑΛΥΜΝΟΥ,1203,5,19,2,24,2021-03-18T00:00:00,1497,1497,744,2241
ΚΑΡΔΙΤΣΑΣ,501,238,39,-42,277,2021-03-18T00:00:00,11705,11705,4525,16230
ΚΑΡΠΑΘΟΥ,1204,0,0,0,0,2021-03-18T00:00:00,478,478,265,743
ΚΑΣΤΟΡΙΑΣ,302,125,73,10,198,2021-03-18T00:00:00,5267,5267,2334,7601
ΚΕΑΣ-ΚΥΘΝΟΥ,1205,54,0,30,54,2021-03-18T00:00:00,258,258,38,296
ΚΕΝΤΡΙΚΟΥ ΤΟΜΕΑ ΑΘΗΝΩΝ,905,2787,1021,-96,3808,2021-03-18T00:00:00,129694,129695,70503,200198
ΚΕΡΚΥΡΑΣ,603,215,32,-7,247,2021-03-18T00:00:00,7911,7911,3454,11365
ΚΕΦΑΛΛΗΝΙΑΣ,604,11,25,-5,36,2021-03-18T00:00:00,4115,4115,1753,5868
ΚΙΛΚΙΣ,203,60,165,27,225,2021-03-18T00:00:00,7334,7334,3607,10941
ΚΟΖΑΝΗΣ,303,274,106,-6,380,2021-03-18T00:00:00,11315,11315,5219,16534
ΚΟΡΙΝΘΙΑΣ,1003,234,34,-8,268,2021-03-18T00:00:00,9039,9039,3426,12465
ΚΩ,1206,17,20,14,37,2021-03-18T00:00:00,3248,3248,1221,4469
ΛΑΚΩΝΙΑΣ,1004,147,30,-17,177,2021-03-18T00:00:00,7492,7492,3326,10818
ΛΑΡΙΣΑΣ,502,505,32,-15,537,2021-03-18T00:00:00,18680,18680,8744,27424
ΛΑΣΙΘΙΟΥ,1302,106,64,-23,170,2021-03-18T00:00:00,8327,8327,4431,12758
ΛΕΣΒΟΥ,1102,137,43,-8,180,2021-03-18T00:00:00,5862,5862,2661,8523
ΛΕΥΚΑΔΑΣ,605,38,25,2,63,2021-03-18T00:00:00,3358,3358,1598,4956
ΛΗΜΝΟΥ,1103,40,12,2,52,2021-03-18T00:00:00,1465,1465,799,2264
ΜΑΓΝΗΣΙΑΣ,503,335,128,22,463,2021-03-18T00:00:00,12568,12568,5314,17882
ΜΕΣΣΗΝΙΑΣ,1005,261,52,-36,313,2021-03-18T00:00:00,11051,11051,5714,16765
ΜΗΛΟΥ,1207,278,5,283,283,2021-03-18T00:00:00,738,738,291,1029
ΜΥΚΟΝΟΥ,1208,0,0,0,0,2021-03-18T00:00:00,188,188,161,349
ΝΑΞΟΥ,1209,1,11,12,12,2021-03-18T00:00:00,892,892,456,1348
ΝΗΣΩΝ,906,120,21,-2,141,2021-03-18T00:00:00,4008,4008,1792,5800
ΝΟΤΙΟΥ ΤΟΜΕΑ ΑΘΗΝΩΝ,907,626,222,41,848,2021-03-18T00:00:00,23829,23829,9838,33667
ΞΑΝΘΗΣ,105,162,82,2,244,2021-03-18T00:00:00,6081,6081,2898,8979
ΠΑΡΟΥ,1210,0,0,0,0,2021-03-18T00:00:00,314,314,310,624
ΠΕΙΡΑΙΩΣ,908,963,487,32,1450,2021-03-18T00:00:00,38137,38137,16938,55075
ΠΕΛΛΑΣ,204,306,44,5,350,2021-03-18T00:00:00,12092,12092,5718,17810
ΠΙΕΡΙΑΣ,205,254,61,-18,315,2021-03-18T00:00:00,7900,7900,4349,12249
ΠΡΕΒΕΖΑΣ,404,143,12,13,155,2021-03-18T00:00:00,5018,5018,1375,6393
ΡΕΘΥΜΝΟΥ,1303,19,157,12,176,2021-03-18T00:00:00,7361,7361,2995,10356
ΡΟΔΟΠΗΣ,106,136,105,14,241,2021-03-18T00:00:00,5503,5503,2722,8225
ΡΟΔΟΥ,1211,174,104,19,278,2021-03-18T00:00:00,7004,7004,3520,10524
ΣΑΜΟΥ,1104,43,11,-5,54,2021-03-18T00:00:00,2395,2395,938,3333
ΣΕΡΡΩΝ,206,176,160,-2,336,2021-03-18T00:00:00,11064,11064,4322,15386
ΣΠΟΡΑΔΩΝ,504,0,0,-6,0,2021-03-18T00:00:00,488,488,286,774
ΣΥΡΟΥ,1212,78,18,5,96,2021-03-18T00:00:00,1634,1634,909,2543
ΤΗΝΟΥ,1213,3,3,-6,6,2021-03-18T00:00:00,325,325,310,635
ΤΡΙΚΑΛΩΝ,505,283,84,-1,367,2021-03-18T00:00:00,11042,11042,5576,16618
ΦΘΙΩΤΙΔΑΣ,804,161,207,3,368,2021-03-18T00:00:00,9528,9528,4493,14021
ΦΛΩΡΙΝΑΣ,304,62,33,-5,95,2021-03-18T00:00:00,4672,4672,1924,6596
ΦΩΚΙΔΑΣ,805,42,8,-2,50,2021-03-18T00:00:00,2541,2541,1138,3679
ΧΑΛΚΙΔΙΚΗΣ,207,105,165,-20,270,2021-03-18T00:00:00,8598,8598,3129,11727
ΧΑΝΙΩΝ,1304,267,60,-83,327,2021-03-18T00:00:00,15226,15226,7268,22494
ΧΙΟΥ,1105,68,52,-1,120,2021-03-18T00:00:00,4464,4464,2124,6588
ΑΙΤΩΛΟΑΚΑΡΝΑΝΙΑΣ,701,338,32,28,370,2021-03-19T00:00:00,11996,11996,4673,16669
ΑΝΑΤΟΛΙΚΗΣ ΑΤΤΙΚΗΣ,901,808,87,57,895,2021-03-19T00:00:00,26263,26263,10175,36438
ΑΝΔΡΟΥ,1201,0,0,-1,0,2021-03-19T00:00:00,316,316,296,612
ΑΡΓΟΛΙΔΑΣ,1001,199,27,23,226,2021-03-19T00:00:00,7656,7656,3202,10858
ΑΡΚΑΔΙΑΣ,1002,157,34,-3,191,2021-03-19T00:00:00,7530,7530,3039,10569
ΑΡΤΑΣ,401,149,33,6,182,2021-03-19T00:00:00,5638,5638,3577,9215
ΑΧΑΪΑΣ,702,596,158,21,754,2021-03-19T00:00:00,22213,22213,10913,33126
ΒΟΙΩΤΙΑΣ,801,235,31,-3,266,2021-03-19T00:00:00,10708,10708,3345,14053
ΒΟΡΕΙΟΥ ΤΟΜΕΑ ΑΘΗΝΩΝ,902,1587,3011,236,4598,2021-03-19T00:00:00,127896,127897,58832,186729
ΓΡΕΒΕΝΩΝ,301,90,36,23,126,2021-03-19T00:00:00,3103,3103,1466,4569
ΔΡΑΜΑΣ,101,191,64,12,255,2021-03-19T00:00:00,7399,7399,3790,11189
ΔΥΤΙΚΗΣ ΑΤΤΙΚΗΣ,903,70,22,-41,92,2021-03-19T00:00:00,8487,8487,3109,11596
ΔΥΤΙΚΟΥ ΤΟΜΕΑ ΑΘΗΝΩΝ,904,1164,213,59,1377,2021-03-19T00:00:00,37877,37877,18778,56655
ΕΒΡΟΥ,102,274,155,14,429,2021-03-19T00:00:00,13363,13363,6563,19926
ΕΥΒΟΙΑΣ,802,387,106,0,493,2021-03-19T00:00:00,16031,16031,6917,22948
ΕΥΡΥΤΑΝΙΑΣ,803,20,4,-7,24,2021-03-19T00:00:00,1690,1690,727,2417
ΖΑΚΥΝΘΟΥ,601,100,4,23,104,2021-03-19T00:00:00,2629,2629,1505,4134
ΗΛΕΙΑΣ,703,276,68,-4,344,2021-03-19T00:00:00,9952,9952,4190,14142
ΗΜΑΘΙΑΣ,201,293,93,22,386,2021-03-19T00:00:00,10389,10389,5409,15798
ΗΡΑΚΛΕΙΟΥ,1301,516,297,64,813,2021-03-19T00:00:00,22669,22669,11259,33928
ΘΑΣΟΥ,103,0,0,0,0,2021-03-19T00:00:00,442,442,438,880
ΘΕΣΠΡΩΤΙΑΣ,402,123,26,-5,149,2021-03-19T00:00:00,5592,5592,2402,7994
ΘΕΣΣΑΛΟΝΙΚΗΣ,202,2042,1586,63,3628,2021-03-19T00:00:00,105533,105535,51284,156819
ΘΗΡΑΣ,1202,32,4,6,36,2021-03-19T00:00:00,925,925,394,1319
ΙΘΑΚΗΣ,602,0,0,0,0,2021-03-19T00:00:00,776,776,130,906
ΙΚΑΡΙΑΣ,1101,0,6,0,6,2021-03-19T00:00:00,1441,1441,709,2150
ΙΩΑΝΝΙΝΩΝ,403,325,140,-24,465,2021-03-19T00:00:00,16057,16058,9234,25292
ΚΑΒΑΛΑΣ,104,315,62,15,377,2021-03-19T00:00:00,9279,9279,5041,14320
ΚΑΛΥΜΝΟΥ,1203,40,171,187,211,2021-03-19T00:00:00,1537,1537,915,2452
ΚΑΡΔΙΤΣΑΣ,501,224,59,6,283,2021-03-19T00:00:00,11929,11929,4584,16513
ΚΑΡΠΑΘΟΥ,1204,0,6,6,6,2021-03-19T00:00:00,478,478,271,749
ΚΑΣΤΟΡΙΑΣ,302,159,41,2,200,2021-03-19T00:00:00,5426,5426,2375,7801
ΚΕΑΣ-ΚΥΘΝΟΥ,1205,30,0,-24,30,2021-03-19T00:00:00,288,288,38,326
ΚΕΝΤΡΙΚΟΥ ΤΟΜΕΑ ΑΘΗΝΩΝ,905,3142,899,233,4041,2021-03-19T00:00:00,132836,132837,71402,204239
ΚΕΡΚΥΡΑΣ,603,239,20,12,259,2021-03-19T00:00:00,8150,8150,3474,11624
ΚΕΦΑΛΛΗΝΙΑΣ,604,8,11,-17,19,2021-03-19T00:00:00,4123,4123,1764,5887
ΚΙΛΚΙΣ,203,109,68,-48,177,2021-03-19T00:00:00,7443,7443,3675,11118
ΚΟΖΑΝΗΣ,303,331,77,28,408,2021-03-19T00:00:00,11646,11646,5296,16942
ΚΟΡΙΝΘΙΑΣ,1003,232,31,-5,263,2021-03-19T00:00:00,9271,9271,3457,12728
ΚΩ,1206,21,12,-4,33,2021-03-19T00:00:00,3269,3269,1233,4502
ΛΑΚΩΝΙΑΣ,1004,152,31,6,183,2021-03-19T00:00:00,7644,7644,3357,11001
ΛΑΡΙΣΑΣ,502,467,62,-8,529,2021-03-19T00:00:00,19147,19147,8806,27953
ΛΑΣΙΘΙΟΥ,1302,118,56,4,174,2021-03-19T00:00:00,8445,8445,4487,12932
ΛΕΣΒΟΥ,1102,169,15,4,184,2021-03-19T00:00:00,6031,6031,2676,8707
ΛΕΥΚΑΔΑΣ,605,42,15,-6,57,2021-03-19T00:00:00,3400,3400,1613,5013
ΛΗΜΝΟΥ,1103,49,5,2,54,2021-03-19T00:00:00,1514,1514,804,2318
ΜΑΓΝΗΣΙΑΣ,503,338,143,18,481,2021-03-19T00:00:00,12906,12906,5457,18363
ΜΕΣΣΗΝΙΑΣ,1005,264,54,5,318,2021-03-19T00:00:00,11315,11315,5768,17083
ΜΗΛΟΥ,1207,325,0,42,325,2021-03-19T00:00:00,1063,1063,291,1354
ΜΥΚΟΝΟΥ,1208,0,0,0,0,2021-03-19T00:00:00,188,188,161,349
ΝΑΞΟΥ,1209,0,6,-6,6,2021-03-19T00:00:00,892,892,462,1354
ΝΗΣΩΝ,906,191,27,77,218,2021-03-19T00:00:00,4199,4199,1819,6018
ΝΟΤΙΟΥ ΤΟΜΕΑ ΑΘΗΝΩΝ,907,692,200,44,892,2021-03-19T00:00:00,24521,24521,10038,34559
ΞΑΝΘΗΣ,105,157,75,-12,232,2021-03-19T00:00:00,6238,6238,2973,9211
ΠΑΡΟΥ,1210,0,0,0,0,2021-03-19T00:00:00,314,314,310,624
ΠΕΙΡΑΙΩΣ,908,1102,403,55,1505,2021-03-19T00:00:00,39239,39239,17341,56580
ΠΕΛΛΑΣ,204,285,45,-20,330,2021-03-19T00:00:00,12377,12377,5763,18140
ΠΙΕΡΙΑΣ,205,279,45,9,324,2021-03-19T00:00:00,8179,8179,4394,12573
ΠΡΕΒΕΖΑΣ,404,140,15,0,155,2021-03-19T00:00:00,5158,5158,1390,6548
ΡΕΘΥΜΝΟΥ,1303,42,95,-39,137,2021-03-19T00:00:00,7403,7403,3090,10493
ΡΟΔΟΠΗΣ,106,188,65,12,253,2021-03-19T00:00:00,5691,5691,2787,8478
ΡΟΔΟΥ,1211,153,94,-31,247,2021-03-19T00:00:00,7157,7157,3614,10771
ΣΑΜΟΥ,1104,44,12,2,56,2021-03-19T00:00:00,2439,2439,950,3389
ΣΕΡΡΩΝ,206,236,114,14,350,2021-03-19T00:00:00,11300,11300,4436,15736
ΣΠΟΡΑΔΩΝ,504,8,4,12,12,2021-03-19T00:00:00,496,496,290,786
ΣΥΡΟΥ,1212,88,3,-5,91,2021-03-19T00:00:00,1722,1722,912,2634
ΤΗΝΟΥ,1213,0,0,-6,0,2021-03-19T00:00:00,325,325,310,635
ΤΡΙΚΑΛΩΝ,505,275,87,-5,362,2021-03-19T00:00:00,11317,11317,5663,16980
ΦΘΙΩΤΙΔΑΣ,804,222,148,2,370,2021-03-19T00:00:00,9750,9750,4641,14391
ΦΛΩΡΙΝΑΣ,304,85,27,17,112,2021-03-19T00:00:00,4757,4757,1951,6708
ΦΩΚΙΔΑΣ,805,38,16,4,54,2021-03-19T00:00:00,2579,2579,1154,3733
ΧΑΛΚΙΔΙΚΗΣ,207,187,80,-3,267,2021-03-19T00:00:00,8785,8785,3209,11994
ΧΑΝΙΩΝ,1304,235,80,-12,315,2021-03-19T00:00:00,15461,15461,7348,22809
ΧΙΟΥ,1105,83,44,7,127,2021-03-19T00:00:00,4547,4547,2168,6715
ΑΙΤΩΛΟΑΚΑΡΝΑΝΙΑΣ,701,344,51,25,395,2021-03-20T00:00:00,12340,12340,4724,17064
ΑΝΑΤΟΛΙΚΗΣ ΑΤΤΙΚΗΣ,901,747,54,-94,801,2021-03-20T00:00:00,27010,27010,10229,37239
ΑΝΔΡΟΥ,1201,0,0,0,0,2021-03-20T00:00:00,316,316,296,612
ΑΡΓΟΛΙΔΑΣ,1001,153,75,2,228,2021-03-20T00:00:00,7809,7809,3277,11086
ΑΡΚΑΔΙΑΣ,1002,180,44,33,224,2021-03-20T00:00:00,7710,7710,3083,10793
ΑΡΤΑΣ,401,154,40,12,194,2021-03-20T00:00:00,5792,5792,3617,9409
ΑΧΑΪΑΣ,702,570,211,27,781,2021-03-20T00:00:00,22783,22783,11124,33907
ΒΟΙΩΤΙΑΣ,801,263,29,26,292,2021-03-20T00:00:00,10971,10971,3374,14345
ΒΟΡΕΙΟΥ ΤΟΜΕΑ ΑΘΗΝΩΝ,902,1063,2663,-872,3726,2021-03-20T00:00:00,128959,128960,61495,190455
ΓΡΕΒΕΝΩΝ,301,80,28,-18,108,2021-03-20T00:00:00,3183,3183,1494,4677
ΔΡΑΜΑΣ,101,139,92,-24,231,2021-03-20T00:00:00,7538,7538,3882,11420
ΔΥΤΙΚΗΣ ΑΤΤΙΚΗΣ,903,81,26,15,107,2021-03-20T00:00:00,8568,8568,3135,11703
ΔΥΤΙΚΟΥ ΤΟΜΕΑ ΑΘΗΝΩΝ,904,1173,164,-40,1337,2021-03-20T00:00:00,39050,39050,18942,57992
ΕΒΡΟΥ,102,401,81,53,482,2021-03-20T00:00:00,13764,13764,6644,20408
ΕΥΒΟΙΑΣ,802,292,120,-81,412,2021-03-20T00:00:00,16323,16323,7037,23360
ΕΥΡΥΤΑΝΙΑΣ,803,4,8,-12,12,2021-03-20T00:00:00,1694,1694,735,2429
ΖΑΚΥΝΘΟΥ,601,76,10,-18,86,2021-03-20T00:00:00,2705,2705,1515,4220
ΗΛΕΙΑΣ,703,285,62,3,347,2021-03-20T00:00:00,10237,10237,4252,14489
ΗΜΑΘΙΑΣ,201,256,100,-30,356,2021-03-20T00:00:00,10645,10645,5509,16154
ΗΡΑΚΛΕΙΟΥ,1301,477,325,-11,802,2021-03-20T00:00:00,23146,23146,11584,34730
ΘΑΣΟΥ,103,4,8,12,12,2021-03-20T00:00:00,446,446,446,892
ΘΕΣΠΡΩΤΙΑΣ,402,138,21,10,159,2021-03-20T00:00:00,5730,5730,2423,8153
ΘΕΣΣΑΛΟΝΙΚΗΣ,202,1856,1576,-196,3432,2021-03-20T00:00:00,107389,107391,52860,160251
ΘΗΡΑΣ,1202,52,2,18,54,2021-03-20T00:00:00,977,977,396,1373
ΙΘΑΚΗΣ,602,0,60,60,60,2021-03-20T00:00:00,776,776,190,966
ΙΚΑΡΙΑΣ,1101,9,107,110,116,2021-03-20T00:00:00,1450,1450,816,2266
ΙΩΑΝΝΙΝΩΝ,403,354,166,55,520,2021-03-20T00:00:00,16411,16412,9400,25812
ΚΑΒΑΛΑΣ,104,277,92,-8,369,2021-03-20T00:00:00,9556,9556,5133,14689
ΚΑΛΥΜΝΟΥ,1203,18,76,-117,94,2021-03-20T00:00:00,1555,1555,991,2546
ΚΑΡΔΙΤΣΑΣ,501,200,118,35,318,2021-03-20T00:00:00,12129,12129,4702,16831
ΚΑΡΠΑΘΟΥ,1204,0,0,-6,0,2021-03-20T00:00:00,478,478,271,749
ΚΑΣΤΟΡΙΑΣ,302,173,35,8,208,2021-03-20T00:00:00,5599,5599,2410,8009
ΚΕΑΣ-ΚΥΘΝΟΥ,1205,71,0,41,71,2021-03-20T00:00:00,359,359,38,397
ΚΕΝΤΡΙΚΟΥ ΤΟΜΕΑ ΑΘΗΝΩΝ,905,3027,636,-378,3663,2021-03-20T00:00:00,135863,135864,72038,207902
ΚΕΡΚΥΡΑΣ,603,280,29,50,309,2021-03-20T00:00:00,8430,8430,3503,11933
ΚΕΦΑΛΛΗΝΙΑΣ,604,12,6,-1,18,2021-03-20T00:00:00,4135,4135,1770,5905
ΚΙΛΚΙΣ,203,138,48,9,186,2021-03-20T00:00:00,7581,7581,3723,11304
ΚΟΖΑΝΗΣ,303,341,73,6,414,2021-03-20T00:00:00,11987,11987,5369,17356
ΚΟΡΙΝΘΙΑΣ,1003,242,36,15,278,2021-03-20T00:00:00,9513,9513,3493,13006
ΚΩ,1206,31,4,2,35,2021-03-20T00:00:00,3300,3300,1237,4537
ΛΑΚΩΝΙΑΣ,1004,143,48,8,191,2021-03-20T00:00:00,7787,7787,3405,11192
ΛΑΡΙΣΑΣ,502,435,98,4,533,2021-03-20T00:00:00,19582,19582,8904,28486
ΛΑΣΙΘΙΟΥ,1302,124,31,-19,155,2021-03-20T00:00:00,8569,8569,4518,13087
ΛΕΣΒΟΥ,1102,177,31,24,208,2021-03-20T00:00:00,6208,6208,2707,8915
ΛΕΥΚΑΔΑΣ,605,52,18,13,70,2021-03-20T00:00:00,3452,3452,1631,5083
ΛΗΜΝΟΥ,1103,43,6,-5,49,2021-03-20T00:00:00,1557,1557,810,2367
ΜΑΓΝΗΣΙΑΣ,503,380,116,15,496,2021-03-20T00:00:00,13286,13286,5573,18859
ΜΕΣΣΗΝΙΑΣ,1005,260,68,10,328,2021-03-20T00:00:00,11575,11575,5836,17411
ΜΗΛΟΥ,1207,80,1,-244,81,2021-03-20T00:00:00,1143,1143,292,1435
ΜΥΚΟΝΟΥ,1208,1,5,6,6,2021-03-20T00:00:00,189,189,166,355
ΝΑΞΟΥ,1209,0,0,-6,0,2021-03-20T00:00:00,892,892,462,1354
ΝΗΣΩΝ,906,107,25,-86,132,2021-03-20T00:00:00,4306,4306,1844,6150
ΝΟΤΙΟΥ ΤΟΜΕΑ ΑΘΗΝΩΝ,907,653,233,-6,886,2021-03-20T00:00:00,25174,25174,10271,35445
ΞΑΝΘΗΣ,105,138,97,3,235,2021-03-20T00:00:00,6376,6376,3070,9446
ΠΑΡΟΥ,1210,0,0,0,0,2021-03-20T00:00:00,314,314,310,624
ΠΕΙΡΑΙΩΣ,908,1071,234,-200,1305,2021-03-20T00:00:00,40310,40310,17575,57885
ΠΕΛΛΑΣ,204,309,42,21,351,2021-03-20T00:00:00,12686,12686,5805,18491
ΠΙΕΡΙΑΣ,205,272,46,-6,318,2021-03-20T00:00:00,8451,8451,4440,12891
ΠΡΕΒΕΖΑΣ,404,155,17,17,172,2021-03-20T00:00:00,5313,5313,1407,6720
ΡΕΘΥΜΝΟΥ,1303,43,39,-55,82,2021-03-20T00:00:00,7446,7446,3129,10575
ΡΟΔΟΠΗΣ,106,185,43,-25,228,2021-03-20T00:00:00,5876,5876,2830,8706
ΡΟΔΟΥ,1211,172,98,23,270,2021-03-20T00:00:00,7329,7329,3712,11041
ΣΑΜΟΥ,1104,46,10,0,56,2021-03-20T00:00:00,2485,2485,960,3445
ΣΕΡΡΩΝ,206,272,97,19,369,2021-03-20T00:00:00,11572,11572,4533,16105
ΣΠΟΡΑΔΩΝ,504,0,0,-12,0,2021-03-20T00:00:00,496,496,290,786
ΣΥΡΟΥ,1212,89,1,-1,90,2021-03-20T00:00:00,1811,1811,913,2724
ΤΗΝΟΥ,1213,0,0,0,0,2021-03-20T00:00:00,325,325,310,635
ΤΡΙΚΑΛΩΝ,505,286,92,16,378,2021-03-20T00:00:00,11603,11603,5755,17358
ΦΘΙΩΤΙΔΑΣ,804,291,98,19,389,2021-03-20T00:00:00,10041,10041,4739,14780
ΦΛΩΡΙΝΑΣ,304,28,26,-58,54,2021-03-20T00:00:00,4785,4785,1977,6762
ΦΩΚΙΔΑΣ,805,33,15,-6,48,2021-03-20T00:00:00,2612,2612,1169,3781
ΧΑΛΚΙΔΙΚΗΣ,207,174,78,-15,252,2021-03-20T00:00:00,8959,8959,3287,12246
ΧΑΝΙΩΝ,1304,242,82,9,324,2021-03-20T00:00:00,15703,15703,7430,23133
ΧΙΟΥ,1105,78,56,7,134,2021-03-20T00:00:00,4625,4625,2224,6849
ΑΙΤΩΛΟΑΚΑΡΝΑΝΙΑΣ,701,363,89,57,452,2021-03-22T00:00:00,12703,12703,4813,17516
ΑΝΑΤΟΛΙΚΗΣ ΑΤΤΙΚΗΣ,901,796,87,82,883,2021-03-22T00:00:00,27806,27806,10316,38122
ΑΝΔΡΟΥ,1201,0,0,0,0,2021-03-22T00:00:00,316,316,296,612
ΑΡΓΟΛΙΔΑΣ,1001,181,63,16,244,2021-03-22T00:00:00,7990,7990,3340,11330
ΑΡΚΑΔΙΑΣ,1002,198,69,43,267,2021-03-22T00:00:00,7908,7908,3152,11060
ΑΡΤΑΣ,401,168,42,16,210,2021-03-22T00:00:00,5960,5960,3659,9619
ΑΧΑΪΑΣ,702,495,320,34,815,2021-03-22T00:00:00,23278,23278,11444,34722
ΒΟΙΩΤΙΑΣ,801,213,103,24,316,2021-03-22T00:00:00,11184,11184,3477,14661
ΒΟΡΕΙΟΥ ΤΟΜΕΑ ΑΘΗΝΩΝ,902,1362,3256,892,4618,2021-03-22T00:00:00,130321,130322,64751,195073
ΓΡΕΒΕΝΩΝ,301,108,25,25,133,2021-03-22T00:00:00,3291,3291,1519,4810
ΔΡΑΜΑΣ,101,207,79,55,286,2021-03-22T00:00:00,7745,7745,3961,11706
ΔΥΤΙΚΗΣ ΑΤΤΙΚΗΣ,903,85,167,145,252,2021-03-22T00:00:00,8653,8653,3302,11955
ΔΥΤΙΚΟΥ ΤΟΜΕΑ ΑΘΗΝΩΝ,904,1216,157,36,1373,2021-03-22T00:00:00,40266,40266,19099,59365
ΕΒΡΟΥ,102,355,135,8,490,2021-03-22T00:00:00,14119,14119,6779,20898
ΕΥΒΟΙΑΣ,802,304,208,100,512,2021-03-22T00:00:00,16627,16627,7245,23872
ΕΥΡΥΤΑΝΙΑΣ,803,9,20,17,29,2021-03-22T00:00:00,1703,1703,755,2458
ΖΑΚΥΝΘΟΥ,601,69,24,7,93,2021-03-22T00:00:00,2774,2774,1539,4313
ΗΛΕΙΑΣ,703,232,165,50,397,2021-03-22T00:00:00,10469,10469,4417,14886
ΗΜΑΘΙΑΣ,201,330,74,48,404,2021-03-22T00:00:00,10975,10975,5583,16558
ΗΡΑΚΛΕΙΟΥ,1301,477,369,44,846,2021-03-22T00:00:00,23623,23623,11953,35576
ΘΑΣΟΥ,103,0,0,-12,0,2021-03-22T00:00:00,446,446,446,892
ΘΕΣΠΡΩΤΙΑΣ,402,146,27,14,173,2021-03-22T00:00:00,5876,5876,2450,8326
ΘΕΣΣΑΛΟΝΙΚΗΣ,202,1618,1825,11,3443,2021-03-22T00:00:00,109007,109009,54685,163694
ΘΗΡΑΣ,1202,42,24,12,66,2021-03-22T00:00:00,1019,1019,420,1439
ΙΘΑΚΗΣ,602,12,54,6,66,2021-03-22T00:00:00,788,788,244,1032
ΙΚΑΡΙΑΣ,1101,6,40,-70,46,2021-03-22T00:00:00,1456,1456,856,2312
ΙΩΑΝΝΙΝΩΝ,403,400,155,35,555,2021-03-22T00:00:00,16811,16812,9555,26367
ΚΑΒΑΛΑΣ,104,273,109,13,382,2021-03-22T00:00:00,9829,9829,5242,15071
ΚΑΛΥΜΝΟΥ,1203,1,23,-70,24,2021-03-22T00:00:00,1556,1556,1014,2570
ΚΑΡΔΙΤΣΑΣ,501,223,123,28,346,2021-03-22T00:00:00,12352,12352,4825,17177
ΚΑΡΠΑΘΟΥ,1204,3,9,12,12,2021-03-22T00:00:00,481,481,280,761
ΚΑΣΤΟΡΙΑΣ,302,166,50,8,216,2021-03-22T00:00:00,5765,5765,2460,8225
ΚΕΑΣ-ΚΥΘΝΟΥ,1205,60,0,-11,60,2021-03-22T00:00:00,419,419,38,457
ΚΕΝΤΡΙΚΟΥ ΤΟΜΕΑ ΑΘΗΝΩΝ,905,3162,1057,556,4219,2021-03-22T00:00:00,139025,139026,73095,212121
ΚΕΡΚΥΡΑΣ,603,220,54,-35,274,2021-03-22T00:00:00,8650,8650,3557,12207
ΚΕΦΑΛΛΗΝΙΑΣ,604,8,31,21,39,2021-03-22T00:00:00,4143,4143,1801,5944
ΚΙΛΚΙΣ,203,143,67,24,210,2021-03-22T00:00:00,7724,7724,3790,11514
ΚΟΖΑΝΗΣ,303,349,79,14,428,2021-03-22T00:00:00,12336,12336,5448,17784
ΚΟΡΙΝΘΙΑΣ,1003,263,55,40,318,2021-03-22T00:00:00,9776,9776,3548,13324
ΚΩ,1206,24,68,57,92,2021-03-22T00:00:00,3324,3324,1305,4629
ΛΑΚΩΝΙΑΣ,1004,141,65,15,206,2021-03-22T00:00:00,7928,7928,3470,11398
ΛΑΡΙΣΑΣ,502,496,142,105,638,2021-03-22T00:00:00,20078,20078,9046,29124
ΛΑΣΙΘΙΟΥ,1302,118,79,42,197,2021-03-22T00:00:00,8687,8687,4597,13284
ΛΕΣΒΟΥ,1102,126,74,-8,200,2021-03-22T00:00:00,6334,6334,2781,9115
ΛΕΥΚΑΔΑΣ,605,44,23,-3,67,2021-03-22T00:00:00,3496,3496,1654,5150
ΛΗΜΝΟΥ,1103,30,25,6,55,2021-03-22T00:00:00,1587,1587,835,2422
ΜΑΓΝΗΣΙΑΣ,503,337,195,36,532,2021-03-22T00:00:00,13623,13623,5768,19391
ΜΕΣΣΗΝΙΑΣ,1005,307,85,64,392,2021-03-22T00:00:00,11882,11882,5921,17803
ΜΗΛΟΥ,1207,114,0,33,114,2021-03-22T00:00:00,1257,1257,292,1549
ΜΥΚΟΝΟΥ,1208,0,0,-6,0,2021-03-22T00:00:00,189,189,166,355
ΝΑΞΟΥ,1209,0,24,24,24,2021-03-22T00:00:00,892,892,486,1378
ΝΗΣΩΝ,906,96,68,32,164,2021-03-22T00:00:00,4402,4402,1912,6314
ΝΟΤΙΟΥ ΤΟΜΕΑ ΑΘΗΝΩΝ,907,820,135,69,955,2021-03-22T00:00:00,25994,25994,10406,36400
ΞΑΝΘΗΣ,105,153,100,18,253,2021-03-22T00:00:00,6529,6529,3170,9699
ΠΑΡΟΥ,1210,0,0,0,0,2021-03-22T00:00:00,314,314,310,624
ΠΕΙΡΑΙΩΣ,908,1057,282,34,1339,2021-03-22T00:00:00,41367,41367,17857,59224
ΠΕΛΛΑΣ,204,272,95,16,367,2021-03-22T00:00:00,12958,12958,5900,18858
ΠΙΕΡΙΑΣ,205,274,75,31,349,2021-03-22T00:00:00,8725,8725,4515,13240
ΠΡΕΒΕΖΑΣ,404,145,26,-1,171,2021-03-22T00:00:00,5458,5458,1433,6891
ΡΕΘΥΜΝΟΥ,1303,63,101,82,164,2021-03-22T00:00:00,7509,7509,3230,10739
ΡΟΔΟΠΗΣ,106,180,73,25,253,2021-03-22T00:00:00,6056,6056,2903,8959
ΡΟΔΟΥ,1211,230,58,18,288,2021-03-22T00:00:00,7559,7559,3770,11329
ΣΑΜΟΥ,1104,43,17,4,60,2021-03-22T00:00:00,2528,2528,977,3505
ΣΕΡΡΩΝ,206,308,82,21,390,2021-03-22T00:00:00,11880,11880,4615,16495
ΣΠΟΡΑΔΩΝ,504,0,0,0,0,2021-03-22T00:00:00,496,496,290,786
ΣΥΡΟΥ,1212,93,6,9,99,2021-03-22T00:00:00,1904,1904,919,2823
ΤΗΝΟΥ,1213,0,0,0,0,2021-03-22T00:00:00,325,325,310,635
ΤΡΙΚΑΛΩΝ,505,303,102,27,405,2021-03-22T00:00:00,11906,11906,5857,17763
ΦΘΙΩΤΙΔΑΣ,804,326,89,26,415,2021-03-22T00:00:00,10367,10367,4828,15195
ΦΛΩΡΙΝΑΣ,304,30,78,54,108,2021-03-22T00:00:00,4815,4815,2055,6870
ΦΩΚΙΔΑΣ,805,47,11,10,58,2021-03-22T00:00:00,2659,2659,1180,3839
ΧΑΛΚΙΔΙΚΗΣ,207,123,50,-79,173,2021-03-22T00:00:00,9082,9082,3337,12419
ΧΑΝΙΩΝ,1304,261,108,45,369,2021-03-22T00:00:00,15964,15964,7538,23502
ΧΙΟΥ,1105,90,45,1,135,2021-03-22T00:00:00,4715,4715,2269,6984
ΑΙΤΩΛΟΑΚΑΡΝΑΝΙΑΣ,701,381,51,-20,432,2021-03-23T00:00:00,13084,13084,4864,17948
ΑΝΑΤΟΛΙΚΗΣ ΑΤΤΙΚΗΣ,901,760,76,-47,836,2021-03-23T00:00:00,28566,28566,10392,38958
ΑΝΔΡΟΥ,1201,53,0,53,53,2021-03-23T00:00:00,369,369,296,665
ΑΡΓΟΛΙΔΑΣ,1001,122,109,-13,231,2021-03-23T00:00:00,8112,8112,3449,11561
ΑΡΚΑΔΙΑΣ,1002,149,87,-31,236,2021-03-23T00:00:00,8057,8057,3239,11296
ΑΡΤΑΣ,401,132,56,-22,188,2021-03-23T00:00:00,6092,6092,3715,9807
ΑΧΑΪΑΣ,702,403,449,37,852,2021-03-23T00:00:00,23681,23681,11893,35574
ΒΟΙΩΤΙΑΣ,801,169,134,-13,303,2021-03-23T00:00:00,11353,11353,3611,14964
ΒΟΡΕΙΟΥ ΤΟΜΕΑ ΑΘΗΝΩΝ,902,1854,3203,439,5057,2021-03-23T00:00:00,132175,132176,67954,200130
ΓΡΕΒΕΝΩΝ,301,83,46,-4,129,2021-03-23T00:00:00,3374,3374,1565,4939
ΔΡΑΜΑΣ,101,156,72,-58,228,2021-03-23T00:00:00,7901,7901,4033,11934
ΔΥΤΙΚΗΣ ΑΤΤΙΚΗΣ,903,88,223,59,311,2021-03-23T00:00:00,8741,8741,3525,12266
ΔΥΤΙΚΟΥ ΤΟΜΕΑ ΑΘΗΝΩΝ,904,1196,179,2,1375,2021-03-23T00:00:00,41462,41462,19278,60740
ΕΒΡΟΥ,102,272,161,-57,433,2021-03-23T00:00:00,14391,14391,6940,21331
ΕΥΒΟΙΑΣ,802,268,366,122,634,2021-03-23T00:00:00,16895,16895,7611,24506
ΕΥΡΥΤΑΝΙΑΣ,803,5,36,12,41,2021-03-23T00:00:00,1708,1708,791,2499
ΖΑΚΥΝΘΟΥ,601,57,84,48,141,2021-03-23T00:00:00,2831,2831,1623,4454
ΗΛΕΙΑΣ,703,168,192,-37,360,2021-03-23T00:00:00,10637,10637,4609,15246
ΗΜΑΘΙΑΣ,201,326,79,1,405,2021-03-23T00:00:00,11301,11301,5662,16963
ΗΡΑΚΛΕΙΟΥ,1301,447,390,-9,837,2021-03-23T00:00:00,24070,24070,12343,36413
ΘΑΣΟΥ,103,55,5,60,60,2021-03-23T00:00:00,501,501,451,952
ΘΕΣΠΡΩΤΙΑΣ,402,117,99,43,216,2021-03-23T00:00:00,5993,5993,2549,8542
ΘΕΣΣΑΛΟΝΙΚΗΣ,202,1798,1942,297,3740,2021-03-23T00:00:00,110805,110807,56627,167434
ΘΗΡΑΣ,1202,120,27,81,147,2021-03-23T00:00:00,1139,1139,447,1586
ΙΘΑΚΗΣ,602,18,60,12,78,2021-03-23T00:00:00,806,806,304,1110
ΙΚΑΡΙΑΣ,1101,4,34,-8,38,2021-03-23T00:00:00,1460,1460,890,2350
ΙΩΑΝΝΙΝΩΝ,403,383,154,-18,537,2021-03-23T00:00:00,17194,17195,9709,26904
ΚΑΒΑΛΑΣ,104,296,80,-6,376,2021-03-23T00:00:00,10125,10125,5322,15447
ΚΑΛΥΜΝΟΥ,1203,5,66,47,71,2021-03-23T00:00:00,1561,1561,1080,2641
ΚΑΡΔΙΤΣΑΣ,501,179,143,-24,322,2021-03-23T00:00:00,12531,12531,4968,17499
ΚΑΡΠΑΘΟΥ,1204,24,30,42,54,2021-03-23T00:00:00,505,505,310,815
ΚΑΣΤΟΡΙΑΣ,302,156,61,1,217,2021-03-23T00:00:00,5921,5921,2521,8442
ΚΕΑΣ-ΚΥΘΝΟΥ,1205,48,0,-12,48,2021-03-23T00:00:00,467,467,38,505
ΚΕΝΤΡΙΚΟΥ ΤΟΜΕΑ ΑΘΗΝΩΝ,905,3009,1079,-131,4088,2021-03-23T00:00:00,142034,142035,74174,216209
ΚΕΡΚΥΡΑΣ,603,157,201,84,358,2021-03-23T00:00:00,8807,8807,3758,12565
ΚΕΦΑΛΛΗΝΙΑΣ,604,9,133,103,142,2021-03-23T00:00:00,4152,4152,1934,6086
ΚΙΛΚΙΣ,203,117,177,84,294,2021-03-23T00:00:00,7841,7841,3967,11808
ΚΟΖΑΝΗΣ,303,336,105,13,441,2021-03-23T00:00:00,12672,12672,5553,18225
ΚΟΡΙΝΘΙΑΣ,1003,262,26,-30,288,2021-03-23T00:00:00,10038,10038,3574,13612
ΚΩ,1206,20,96,24,116,2021-03-23T00:00:00,3344,3344,1401,4745
ΛΑΚΩΝΙΑΣ,1004,93,105,-8,198,2021-03-23T00:00:00,8021,8021,3575,11596
ΛΑΡΙΣΑΣ,502,571,97,30,668,2021-03-23T00:00:00,20649,20649,9143,29792
ΛΑΣΙΘΙΟΥ,1302,85,255,143,340,2021-03-23T00:00:00,8772,8772,4852,13624
ΛΕΣΒΟΥ,1102,86,117,3,203,2021-03-23T00:00:00,6420,6420,2898,9318
ΛΕΥΚΑΔΑΣ,605,28,34,-5,62,2021-03-23T00:00:00,3524,3524,1688,5212
ΛΗΜΝΟΥ,1103,33,37,15,70,2021-03-23T00:00:00,1620,1620,872,2492
ΜΑΓΝΗΣΙΑΣ,503,323,213,4,536,2021-03-23T00:00:00,13946,13946,5981,19927
ΜΕΣΣΗΝΙΑΣ,1005,231,110,-51,341,2021-03-23T00:00:00,12113,12113,6031,18144
ΜΗΛΟΥ,1207,89,1,-24,90,2021-03-23T00:00:00,1346,1346,293,1639
ΜΥΚΟΝΟΥ,1208,47,1,48,48,2021-03-23T00:00:00,236,236,167,403
ΝΑΞΟΥ,1209,0,30,6,30,2021-03-23T00:00:00,892,892,516,1408
ΝΗΣΩΝ,906,206,96,138,302,2021-03-23T00:00:00,4608,4608,2008,6616
ΝΟΤΙΟΥ ΤΟΜΕΑ ΑΘΗΝΩΝ,907,968,91,104,1059,2021-03-23T00:00:00,26962,26962,10497,37459
ΞΑΝΘΗΣ,105,146,106,-1,252,2021-03-23T00:00:00,6675,6675,3276,9951
ΠΑΡΟΥ,1210,53,1,54,54,2021-03-23T00:00:00,367,367,311,678
ΠΕΙΡΑΙΩΣ,908,1012,424,97,1436,2021-03-23T00:00:00,42379,42379,18281,60660
ΠΕΛΛΑΣ,204,175,145,-47,320,2021-03-23T00:00:00,13133,13133,6045,19178
ΠΙΕΡΙΑΣ,205,236,120,7,356,2021-03-23T00:00:00,8961,8961,4635,13596
ΠΡΕΒΕΖΑΣ,404,136,40,5,176,2021-03-23T00:00:00,5594,5594,1473,7067
ΡΕΘΥΜΝΟΥ,1303,54,161,51,215,2021-03-23T00:00:00,7563,7563,3391,10954
ΡΟΔΟΠΗΣ,106,166,81,-6,247,2021-03-23T00:00:00,6222,6222,2984,9206
ΡΟΔΟΥ,1211,157,111,-20,268,2021-03-23T00:00:00,7716,7716,3881,11597
ΣΑΜΟΥ,1104,40,28,8,68,2021-03-23T00:00:00,2568,2568,1005,3573
ΣΕΡΡΩΝ,206,291,73,-26,364,2021-03-23T00:00:00,12171,12171,4688,16859
ΣΠΟΡΑΔΩΝ,504,120,18,138,138,2021-03-23T00:00:00,616,616,308,924
ΣΥΡΟΥ,1212,76,23,0,99,2021-03-23T00:00:00,1980,1980,942,2922
ΤΗΝΟΥ,1213,48,0,48,48,2021-03-23T00:00:00,373,373,310,683
ΤΡΙΚΑΛΩΝ,505,314,86,-5,400,2021-03-23T00:00:00,12220,12220,5943,18163
ΦΘΙΩΤΙΔΑΣ,804,280,134,-1,414,2021-03-23T00:00:00,10647,10647,4962,15609
ΦΛΩΡΙΝΑΣ,304,23,97,12,120,2021-03-23T00:00:00,4838,4838,2152,6990
ΦΩΚΙΔΑΣ,805,18,36,-4,54,2021-03-23T00:00:00,2677,2677,1216,3893
ΧΑΛΚΙΔΙΚΗΣ,207,70,143,40,213,2021-03-23T00:00:00,9152,9152,3480,12632
ΧΑΝΙΩΝ,1304,229,193,53,422,2021-03-23T00:00:00,16193,16193,7731,23924
ΧΙΟΥ,1105,105,38,8,143,2021-03-23T00:00:00,4820,4820,2307,7127
ΑΙΤΩΛΟΑΚΑΡΝΑΝΙΑΣ,701,313,73,-46,386,2021-03-24T00:00:00,13397,13397,4937,18334
ΑΝΑΤΟΛΙΚΗΣ ΑΤΤΙΚΗΣ,901,570,244,-22,814,2021-03-24T00:00:00,29136,29136,10636,39772
ΑΝΔΡΟΥ,1201,49,0,-4,49,2021-03-24T00:00:00,418,418,296,714
ΑΡΓΟΛΙΔΑΣ,1001,94,130,-7,224,2021-03-24T00:00:00,8206,8206,3579,11785
ΑΡΚΑΔΙΑΣ,1002,110,113,-13,223,2021-03-24T00:00:00,8167,8167,3352,11519
ΑΡΤΑΣ,401,79,99,-10,178,2021-03-24T00:00:00,6171,6171,3814,9985
ΑΧΑΪΑΣ,702,395,460,3,855,2021-03-24T00:00:00,24076,24076,12353,36429
ΒΟΙΩΤΙΑΣ,801,116,177,-10,293,2021-03-24T00:00:00,11469,11469,3788,15257
ΒΟΡΕΙΟΥ ΤΟΜΕΑ ΑΘΗΝΩΝ,902,1562,3436,-59,4998,2021-03-24T00:00:00,133737,133738,71390,205128
ΓΡΕΒΕΝΩΝ,301,46,40,-43,86,2021-03-24T00:00:00,3420,3420,1605,5025
ΔΡΑΜΑΣ,101,118,121,11,239,2021-03-24T00:00:00,8019,8019,4154,12173
ΔΥΤΙΚΗΣ ΑΤΤΙΚΗΣ,903,75,227,-9,302,2021-03-24T00:00:00,8816,8816,3752,12568
ΔΥΤΙΚΟΥ ΤΟΜΕΑ ΑΘΗΝΩΝ,904,1004,375,4,1379,2021-03-24T00:00:00,42466,42466,19653,62119
ΕΒΡΟΥ,102,205,232,4,437,2021-03-24T00:00:00,14596,14596,7172,21768
ΕΥΒΟΙΑΣ,802,194,386,-54,580,2021-03-24T00:00:00,17089,17089,7997,25086
ΕΥΡΥΤΑΝΙΑΣ,803,4,38,1,42,2021-03-24T00:00:00,1712,1712,829,2541
ΖΑΚΥΝΘΟΥ,601,57,82,-2,139,2021-03-24T00:00:00,2888,2888,1705,4593
ΗΛΕΙΑΣ,703,151,223,14,374,2021-03-24T00:00:00,10788,10788,4832,15620
ΗΜΑΘΙΑΣ,201,238,130,-37,368,2021-03-24T00:00:00,11539,11539,5792,17331
ΗΡΑΚΛΕΙΟΥ,1301,380,425,-32,805,2021-03-24T00:00:00,24450,24450,12768,37218
ΘΑΣΟΥ,103,47,1,-12,48,2021-03-24T00:00:00,548,548,452,1000
ΘΕΣΠΡΩΤΙΑΣ,402,117,126,27,243,2021-03-24T00:00:00,6110,6110,2675,8785
ΘΕΣΣΑΛΟΝΙΚΗΣ,202,1586,2213,59,3799,2021-03-24T00:00:00,112391,112393,58840,171233
ΘΗΡΑΣ,1202,0,42,-105,42,2021-03-24T00:00:00,1139,1139,489,1628
ΙΘΑΚΗΣ,602,6,60,-12,66,2021-03-24T00:00:00,812,812,364,1176
ΙΚΑΡΙΑΣ,1101,5,35,2,40,2021-03-24T00:00:00,1465,1465,925,2390
ΙΩΑΝΝΙΝΩΝ,403,310,213,-14,523,2021-03-24T00:00:00,17504,17505,9922,27427
ΚΑΒΑΛΑΣ,104,215,145,-16,360,2021-03-24T00:00:00,10340,10340,5467,15807
ΚΑΛΥΜΝΟΥ,1203,5,23,-43,28,2021-03-24T00:00:00,1566,1566,1103,2669
ΚΑΡΔΙΤΣΑΣ,501,117,179,-26,296,2021-03-24T00:00:00,12648,12648,5147,17795
ΚΑΡΠΑΘΟΥ,1204,84,23,53,107,2021-03-24T00:00:00,589,589,333,922
ΚΑΣΤΟΡΙΑΣ,302,124,88,-5,212,2021-03-24T00:00:00,6045,6045,2609,8654
ΚΕΑΣ-ΚΥΘΝΟΥ,1205,78,0,30,78,2021-03-24T00:00:00,545,545,38,583
ΚΕΝΤΡΙΚΟΥ ΤΟΜΕΑ ΑΘΗΝΩΝ,905,2554,1405,-129,3959,2021-03-24T00:00:00,144588,144589,75579,220168
ΚΕΡΚΥΡΑΣ,603,108,235,-15,343,2021-03-24T00:00:00,8915,8915,3993,12908
ΚΕΦΑΛΛΗΝΙΑΣ,604,5,117,-20,122,2021-03-24T00:00:00,4157,4157,2051,6208
ΚΙΛΚΙΣ,203,128,80,-86,208,2021-03-24T00:00:00,7969,7969,4047,12016
ΚΟΖΑΝΗΣ,303,286,116,-39,402,2021-03-24T00:00:00,12958,12958,5669,18627
ΚΟΡΙΝΘΙΑΣ,1003,204,74,-10,278,2021-03-24T00:00:00,10242,10242,3648,13890
ΚΩ,1206,19,118,21,137,2021-03-24T00:00:00,3363,3363,1519,4882
ΛΑΚΩΝΙΑΣ,1004,40,127,-31,167,2021-03-24T00:00:00,8061,8061,3702,11763
ΛΑΡΙΣΑΣ,502,455,123,-90,578,2021-03-24T00:00:00,21104,21104,9266,30370
ΛΑΣΙΘΙΟΥ,1302,75,260,-5,335,2021-03-24T00:00:00,8847,8847,5112,13959
ΛΕΣΒΟΥ,1102,84,121,2,205,2021-03-24T00:00:00,6504,6504,3019,9523
ΛΕΥΚΑΔΑΣ,605,17,167,122,184,2021-03-24T00:00:00,3541,3541,1855,5396
ΛΗΜΝΟΥ,1103,30,36,-4,66,2021-03-24T00:00:00,1650,1650,908,2558
ΜΑΓΝΗΣΙΑΣ,503,299,226,-11,525,2021-03-24T00:00:00,14245,14245,6207,20452
ΜΕΣΣΗΝΙΑΣ,1005,165,170,-6,335,2021-03-24T00:00:00,12278,12278,6201,18479
ΜΗΛΟΥ,1207,47,1,-42,48,2021-03-24T00:00:00,1393,1393,294,1687
ΜΥΚΟΝΟΥ,1208,48,0,0,48,2021-03-24T00:00:00,284,284,167,451
ΝΑΞΟΥ,1209,0,42,12,42,2021-03-24T00:00:00,892,892,558,1450
ΝΗΣΩΝ,906,173,91,-38,264,2021-03-24T00:00:00,4781,4781,2099,6880
ΝΟΤΙΟΥ ΤΟΜΕΑ ΑΘΗΝΩΝ,907,775,163,-121,938,2021-03-24T00:00:00,27737,27737,10660,38397
ΞΑΝΘΗΣ,105,104,148,0,252,2021-03-24T00:00:00,6779,6779,3424,10203
ΠΑΡΟΥ,1210,54,0,0,54,2021-03-24T00:00:00,421,421,311,732
ΠΕΙΡΑΙΩΣ,908,709,636,-91,1345,2021-03-24T00:00:00,43088,43088,18917,62005
ΠΕΛΛΑΣ,204,99,212,-9,311,2021-03-24T00:00:00,13232,13232,6257,19489
ΠΙΕΡΙΑΣ,205,176,129,-51,305,2021-03-24T00:00:00,9137,9137,4764,13901
ΠΡΕΒΕΖΑΣ,404,118,43,-15,161,2021-03-24T00:00:00,5712,5712,1516,7228
ΡΕΘΥΜΝΟΥ,1303,33,163,-19,196,2021-03-24T00:00:00,7596,7596,3554,11150
ΡΟΔΟΠΗΣ,106,147,90,-10,237,2021-03-24T00:00:00,6369,6369,3074,9443
ΡΟΔΟΥ,1211,144,106,-18,250,2021-03-24T00:00:00,7860,7860,3987,11847
ΣΑΜΟΥ,1104,19,41,-8,60,2021-03-24T00:00:00,2587,2587,1046,3633
ΣΕΡΡΩΝ,206,226,107,-31,333,2021-03-24T00:00:00,12397,12397,4795,17192
ΣΠΟΡΑΔΩΝ,504,97,41,0,138,2021-03-24T00:00:00,713,713,349,1062
ΣΥΡΟΥ,1212,56,34,-9,90,2021-03-24T00:00:00,2036,2036,976,3012
ΤΗΝΟΥ,1213,49,5,6,54,2021-03-24T00:00:00,422,422,315,737
ΤΡΙΚΑΛΩΝ,505,242,150,-8,392,2021-03-24T00:00:00,12462,12462,6093,18555
ΦΘΙΩΤΙΔΑΣ,804,272,141,-1,413,2021-03-24T00:00:00,10919,10919,5103,16022
ΦΛΩΡΙΝΑΣ,304,30,125,35,155,2021-03-24T00:00:00,4868,4868,2277,7145
ΦΩΚΙΔΑΣ,805,17,47,10,64,2021-03-24T00:00:00,2694,2694,1263,3957
ΧΑΛΚΙΔΙΚΗΣ,207,37,189,13,226,2021-03-24T00:00:00,9189,9189,3669,12858
ΧΑΝΙΩΝ,1304,163,307,48,470,2021-03-24T00:00:00,16356,16356,8038,24394
ΧΙΟΥ,1105,115,52,24,167,2021-03-24T00:00:00,4935,4935,2359,7294
ΑΙΤΩΛΟΑΚΑΡΝΑΝΙΑΣ,701,0,0,0,0,2020-12-28T00:00:00,0,0,0,0
ΑΝΑΤΟΛΙΚΗΣ ΑΤΤΙΚΗΣ,901,55,0,20,55,2020-12-28T00:00:00,90,90,0,90
ΑΝΔΡΟΥ,1201,0,0,0,0,2020-12-28T00:00:00,0,0,0,0
ΑΡΓΟΛΙΔΑΣ,1001,0,0,0,0,2020-12-28T00:00:00,0,0,0,0
ΑΡΚΑΔΙΑΣ,1002,0,0,0,0,2020-12-28T00:00:00,0,0,0,0
ΑΡΤΑΣ,401,0,0,0,0,2020-12-28T00:00:00,0,0,0,0
ΑΧΑΪΑΣ,702,0,0,0,0,2020-12-28T00:00:00,0,0,0,0
ΒΟΙΩΤΙΑΣ,801,0,0,0,0,2020-12-28T00:00:00,0,0,0,0
ΒΟΡΕΙΟΥ ΤΟΜΕΑ ΑΘΗΝΩΝ,902,0,0,0,0,2020-12-28T00:00:00,0,0,0,0
ΓΡΕΒΕΝΩΝ,301,0,0,0,0,2020-12-28T00:00:00,0,0,0,0
ΔΡΑΜΑΣ,101,0,0,0,0,2020-12-28T00:00:00,0,0,0,0
ΔΥΤΙΚΗΣ ΑΤΤΙΚΗΣ,903,56,0,7,56,2020-12-28T00:00:00,105,105,0,105
ΔΥΤΙΚΟΥ ΤΟΜΕΑ ΑΘΗΝΩΝ,904,55,0,5,55,2020-12-28T00:00:00,105,105,0,105
ΕΒΡΟΥ,102,0,0,0,0,2020-12-28T00:00:00,0,0,0,0
ΕΥΒΟΙΑΣ,802,0,0,0,0,2020-12-28T00:00:00,0,0,0,0
ΕΥΡΥΤΑΝΙΑΣ,803,0,0,0,0,2020-12-28T00:00:00,0,0,0,0
ΖΑΚΥΝΘΟΥ,601,0,0,0,0,2020-12-28T00:00:00,0,0,0,0
ΗΛΕΙΑΣ,703,0,0,0,0,2020-12-28T00:00:00,0,0,0,0
ΗΜΑΘΙΑΣ,201,0,0,0,0,2020-12-28T00:00:00,0,0,0,0
ΗΡΑΚΛΕΙΟΥ,1301,0,0,0,0,2020-12-28T00:00:00,0,0,0,0
ΘΑΣΟΥ,103,0,0,0,0,2020-12-28T00:00:00,0,0,0,0
ΘΕΣΠΡΩΤΙΑΣ,402,0,0,0,0,2020-12-28T00:00:00,0,0,0,0
ΘΕΣΣΑΛΟΝΙΚΗΣ,202,0,0,0,0,2020-12-28T00:00:00,0,0,0,0
ΘΗΡΑΣ,1202,0,0,0,0,2020-12-28T00:00:00,0,0,0,0
ΙΘΑΚΗΣ,602,0,0,0,0,2020-12-28T00:00:00,0,0,0,0
ΙΚΑΡΙΑΣ,1101,0,0,0,0,2020-12-28T00:00:00,0,0,0,0
ΙΩΑΝΝΙΝΩΝ,403,0,0,0,0,2020-12-28T00:00:00,0,0,0,0
ΚΑΒΑΛΑΣ,104,0,0,0,0,2020-12-28T00:00:00,0,0,0,0
ΚΑΛΥΜΝΟΥ,1203,0,0,0,0,2020-12-28T00:00:00,0,0,0,0
ΚΑΡΔΙΤΣΑΣ,501,0,0,0,0,2020-12-28T00:00:00,0,0,0,0
ΚΑΡΠΑΘΟΥ,1204,0,0,0,0,2020-12-28T00:00:00,0,0,0,0
ΚΑΣΤΟΡΙΑΣ,302,0,0,0,0,2020-12-28T00:00:00,0,0,0,0
ΚΕΑΣ-ΚΥΘΝΟΥ,1205,0,0,0,0,2020-12-28T00:00:00,0,0,0,0
ΚΕΝΤΡΙΚΟΥ ΤΟΜΕΑ ΑΘΗΝΩΝ,905,61,0,-25,61,2020-12-28T00:00:00,147,147,0,147
ΚΕΡΚΥΡΑΣ,603,0,0,0,0,2020-12-28T00:00:00,0,0,0,0
ΚΕΦΑΛΛΗΝΙΑΣ,604,0,0,0,0,2020-12-28T00:00:00,0,0,0,0
ΚΙΛΚΙΣ,203,0,0,0,0,2020-12-28T00:00:00,0,0,0,0
ΚΟΖΑΝΗΣ,303,0,0,0,0,2020-12-28T00:00:00,0,0,0,0
ΚΟΡΙΝΘΙΑΣ,1003,0,0,0,0,2020-12-28T00:00:00,0,0,0,0
ΚΩ,1206,0,0,0,0,2020-12-28T00:00:00,0,0,0,0
ΛΑΚΩΝΙΑΣ,1004,0,0,0,0,2020-12-28T00:00:00,0,0,0,0
ΛΑΡΙΣΑΣ,502,0,0,0,0,2020-12-28T00:00:00,0,0,0,0
ΛΑΣΙΘΙΟΥ,1302,0,0,0,0,2020-12-28T00:00:00,0,0,0,0
ΛΕΣΒΟΥ,1102,0,0,0,0,2020-12-28T00:00:00,0,0,0,0
ΛΕΥΚΑΔΑΣ,605,0,0,0,0,2020-12-28T00:00:00,0,0,0,0
ΛΗΜΝΟΥ,1103,0,0,0,0,2020-12-28T00:00:00,0,0,0,0
ΜΑΓΝΗΣΙΑΣ,503,0,0,0,0,2020-12-28T00:00:00,0,0,0,0
ΜΕΣΣΗΝΙΑΣ,1005,0,0,0,0,2020-12-28T00:00:00,0,0,0,0
ΜΗΛΟΥ,1207,0,0,0,0,2020-12-28T00:00:00,0,0,0,0
ΜΥΚΟΝΟΥ,1208,0,0,0,0,2020-12-28T00:00:00,0,0,0,0
ΝΑΞΟΥ,1209,0,0,0,0,2020-12-28T00:00:00,0,0,0,0
ΝΗΣΩΝ,906,0,0,0,0,2020-12-28T00:00:00,0,0,0,0
ΝΟΤΙΟΥ ΤΟΜΕΑ ΑΘΗΝΩΝ,907,0,0,0,0,2020-12-28T00:00:00,0,0,0,0
ΞΑΝΘΗΣ,105,0,0,0,0,2020-12-28T00:00:00,0,0,0,0
ΠΑΡΟΥ,1210,0,0,0,0,2020-12-28T00:00:00,0,0,0,0
ΠΕΙΡΑΙΩΣ,908,0,0,0,0,2020-12-28T00:00:00,0,0,0,0
ΠΕΛΛΑΣ,204,0,0,0,0,2020-12-28T00:00:00,0,0,0,0
ΠΙΕΡΙΑΣ,205,0,0,0,0,2020-12-28T00:00:00,0,0,0,0
ΠΡΕΒΕΖΑΣ,404,0,0,0,0,2020-12-28T00:00:00,0,0,0,0
ΡΕΘΥΜΝΟΥ,1303,0,0,0,0,2020-12-28T00:00:00,0,0,0,0
ΡΟΔΟΠΗΣ,106,0,0,0,0,2020-12-28T00:00:00,0,0,0,0
ΡΟΔΟΥ,1211,0,0,0,0,2020-12-28T00:00:00,0,0,0,0
ΣΑΜΟΥ,1104,0,0,0,0,2020-12-28T00:00:00,0,0,0,0
ΣΕΡΡΩΝ,206,0,0,0,0,2020-12-28T00:00:00,0,0,0,0
ΣΠΟΡΑΔΩΝ,504,0,0,0,0,2020-12-28T00:00:00,0,0,0,0
ΣΥΡΟΥ,1212,0,0,0,0,2020-12-28T00:00:00,0,0,0,0
ΤΗΝΟΥ,1213,0,0,0,0,2020-12-28T00:00:00,0,0,0,0
ΤΡΙΚΑΛΩΝ,505,0,0,0,0,2020-12-28T00:00:00,0,0,0,0
ΦΘΙΩΤΙΔΑΣ,804,0,0,0,0,2020-12-28T00:00:00,0,0,0,0
ΦΛΩΡΙΝΑΣ,304,0,0,0,0,2020-12-28T00:00:00,0,0,0,0
ΦΩΚΙΔΑΣ,805,0,0,0,0,2020-12-28T00:00:00,0,0,0,0
ΧΑΛΚΙΔΙΚΗΣ,207,0,0,0,0,2020-12-28T00:00:00,0,0,0,0
ΧΑΝΙΩΝ,1304,0,0,0,0,2020-12-28T00:00:00,0,0,0,0
ΧΙΟΥ,1105,0,0,0,0,2020-12-28T00:00:00,0,0,0,0
ΑΙΤΩΛΟΑΚΑΡΝΑΝΙΑΣ,701,0,0,0,0,2020-12-29T00:00:00,0,0,0,0
ΑΝΑΤΟΛΙΚΗΣ ΑΤΤΙΚΗΣ,901,56,0,1,56,2020-12-29T00:00:00,146,146,0,146
ΑΝΔΡΟΥ,1201,0,0,0,0,2020-12-29T00:00:00,0,0,0,0
ΑΡΓΟΛΙΔΑΣ,1001,0,0,0,0,2020-12-29T00:00:00,0,0,0,0
ΑΡΚΑΔΙΑΣ,1002,0,0,0,0,2020-12-29T00:00:00,0,0,0,0
ΑΡΤΑΣ,401,0,0,0,0,2020-12-29T00:00:00,0,0,0,0
ΑΧΑΪΑΣ,702,114,0,114,114,2020-12-29T00:00:00,114,114,0,114
ΒΟΙΩΤΙΑΣ,801,0,0,0,0,2020-12-29T00:00:00,0,0,0,0
ΒΟΡΕΙΟΥ ΤΟΜΕΑ ΑΘΗΝΩΝ,902,0,0,0,0,2020-12-29T00:00:00,0,0,0,0
ΓΡΕΒΕΝΩΝ,301,0,0,0,0,2020-12-29T00:00:00,0,0,0,0
ΔΡΑΜΑΣ,101,0,0,0,0,2020-12-29T00:00:00,0,0,0,0
ΔΥΤΙΚΗΣ ΑΤΤΙΚΗΣ,903,45,0,-11,45,2020-12-29T00:00:00,150,150,0,150
ΔΥΤΙΚΟΥ ΤΟΜΕΑ ΑΘΗΝΩΝ,904,55,0,0,55,2020-12-29T00:00:00,160,160,0,160
ΕΒΡΟΥ,102,0,0,0,0,2020-12-29T00:00:00,0,0,0,0
ΕΥΒΟΙΑΣ,802,0,0,0,0,2020-12-29T00:00:00,0,0,0,0
ΕΥΡΥΤΑΝΙΑΣ,803,0,0,0,0,2020-12-29T00:00:00,0,0,0,0
ΖΑΚΥΝΘΟΥ,601,0,0,0,0,2020-12-29T00:00:00,0,0,0,0
ΗΛΕΙΑΣ,703,0,0,0,0,2020-12-29T00:00:00,0,0,0,0
ΗΜΑΘΙΑΣ,201,0,0,0,0,2020-12-29T00:00:00,0,0,0,0
ΗΡΑΚΛΕΙΟΥ,1301,0,0,0,0,2020-12-29T00:00:00,0,0,0,0
ΘΑΣΟΥ,103,0,0,0,0,2020-12-29T00:00:00,0,0,0,0
ΘΕΣΠΡΩΤΙΑΣ,402,0,0,0,0,2020-12-29T00:00:00,0,0,0,0
ΘΕΣΣΑΛΟΝΙΚΗΣ,202,58,0,58,58,2020-12-29T00:00:00,58,58,0,58
ΘΗΡΑΣ,1202,0,0,0,0,2020-12-29T00:00:00,0,0,0,0
ΙΘΑΚΗΣ,602,0,0,0,0,2020-12-29T00:00:00,0,0,0,0
ΙΚΑΡΙΑΣ,1101,0,0,0,0,2020-12-29T00:00:00,0,0,0,0
ΙΩΑΝΝΙΝΩΝ,403,77,0,77,77,2020-12-29T00:00:00,77,77,0,77
ΚΑΒΑΛΑΣ,104,0,0,0,0,2020-12-29T00:00:00,0,0,0,0
ΚΑΛΥΜΝΟΥ,1203,0,0,0,0,2020-12-29T00:00:00,0,0,0,0
ΚΑΡΔΙΤΣΑΣ,501,0,0,0,0,2020-12-29T00:00:00,0,0,0,0
ΚΑΡΠΑΘΟΥ,1204,0,0,0,0,2020-12-29T00:00:00,0,0,0,0
ΚΑΣΤΟΡΙΑΣ,302,0,0,0,0,2020-12-29T00:00:00,0,0,0,0
ΚΕΑΣ-ΚΥΘΝΟΥ,1205,0,0,0,0,2020-12-29T00:00:00,0,0,0,0
ΚΕΝΤΡΙΚΟΥ ΤΟΜΕΑ ΑΘΗΝΩΝ,905,120,0,59,120,2020-12-29T00:00:00,267,267,0,267
ΚΕΡΚΥΡΑΣ,603,0,0,0,0,2020-12-29T00:00:00,0,0,0,0
ΚΕΦΑΛΛΗΝΙΑΣ,604,0,0,0,0,2020-12-29T00:00:00,0,0,0,0
ΚΙΛΚΙΣ,203,0,0,0,0,2020-12-29T00:00:00,0,0,0,0
ΚΟΖΑΝΗΣ,303,0,0,0,0,2020-12-29T00:00:00,0,0,0,0
ΚΟΡΙΝΘΙΑΣ,1003,0,0,0,0,2020-12-29T00:00:00,0,0,0,0
ΚΩ,1206,0,0,0,0,2020-12-29T00:00:00,0,0,0,0
ΛΑΚΩΝΙΑΣ,1004,0,0,0,0,2020-12-29T00:00:00,0,0,0,0
ΛΑΡΙΣΑΣ,502,105,0,105,105,2020-12-29T00:00:00,105,105,0,105
ΛΑΣΙΘΙΟΥ,1302,0,0,0,0,2020-12-29T00:00:00,0,0,0,0
ΛΕΣΒΟΥ,1102,0,0,0,0,2020-12-29T00:00:00,0,0,0,0
ΛΕΥΚΑΔΑΣ,605,0,0,0,0,2020-12-29T00:00:00,0,0,0,0
ΛΗΜΝΟΥ,1103,0,0,0,0,2020-12-29T00:00:00,0,0,0,0
ΜΑΓΝΗΣΙΑΣ,503,0,0,0,0,2020-12-29T00:00:00,0,0,0,0
ΜΕΣΣΗΝΙΑΣ,1005,0,0,0,0,2020-12-29T00:00:00,0,0,0,0
ΜΗΛΟΥ,1207,0,0,0,0,2020-12-29T00:00:00,0,0,0,0
ΜΥΚΟΝΟΥ,1208,0,0,0,0,2020-12-29T00:00:00,0,0,0,0
ΝΑΞΟΥ,1209,0,0,0,0,2020-12-29T00:00:00,0,0,0,0
ΝΗΣΩΝ,906,0,0,0,0,2020-12-29T00:00:00,0,0,0,0
ΝΟΤΙΟΥ ΤΟΜΕΑ ΑΘΗΝΩΝ,907,0,0,0,0,2020-12-29T00:00:00,0,0,0,0
ΞΑΝΘΗΣ,105,0,0,0,0,2020-12-29T00:00:00,0,0,0,0
ΠΑΡΟΥ,1210,0,0,0,0,2020-12-29T00:00:00,0,0,0,0
ΠΕΙΡΑΙΩΣ,908,0,0,0,0,2020-12-29T00:00:00,0,0,0,0
ΠΕΛΛΑΣ,204,0,0,0,0,2020-12-29T00:00:00,0,0,0,0
ΠΙΕΡΙΑΣ,205,0,0,0,0,2020-12-29T00:00:00,0,0,0,0
ΠΡΕΒΕΖΑΣ,404,0,0,0,0,2020-12-29T00:00:00,0,0,0,0
ΡΕΘΥΜΝΟΥ,1303,0,0,0,0,2020-12-29T00:00:00,0,0,0,0
ΡΟΔΟΠΗΣ,106,0,0,0,0,2020-12-29T00:00:00,0,0,0,0
ΡΟΔΟΥ,1211,0,0,0,0,2020-12-29T00:00:00,0,0,0,0
ΣΑΜΟΥ,1104,0,0,0,0,2020-12-29T00:00:00,0,0,0,0
ΣΕΡΡΩΝ,206,0,0,0,0,2020-12-29T00:00:00,0,0,0,0
ΣΠΟΡΑΔΩΝ,504,0,0,0,0,2020-12-29T00:00:00,0,0,0,0
ΣΥΡΟΥ,1212,0,0,0,0,2020-12-29T00:00:00,0,0,0,0
ΤΗΝΟΥ,1213,0,0,0,0,2020-12-29T00:00:00,0,0,0,0
ΤΡΙΚΑΛΩΝ,505,0,0,0,0,2020-12-29T00:00:00,0,0,0,0
ΦΘΙΩΤΙΔΑΣ,804,0,0,0,0,2020-12-29T00:00:00,0,0,0,0
ΦΛΩΡΙΝΑΣ,304,0,0,0,0,2020-12-29T00:00:00,0,0,0,0
ΦΩΚΙΔΑΣ,805,0,0,0,0,2020-12-29T00:00:00,0,0,0,0
ΧΑΛΚΙΔΙΚΗΣ,207,0,0,0,0,2020-12-29T00:00:00,0,0,0,0
ΧΑΝΙΩΝ,1304,0,0,0,0,2020-12-29T00:00:00,0,0,0,0
ΧΙΟΥ,1105,0,0,0,0,2020-12-29T00:00:00,0,0,0,0
ΑΙΤΩΛΟΑΚΑΡΝΑΝΙΑΣ,701,0,0,0,0,2020-12-30T00:00:00,0,0,0,0
ΑΝΑΤΟΛΙΚΗΣ ΑΤΤΙΚΗΣ,901,40,0,-16,40,2020-12-30T00:00:00,186,186,0,186
ΑΝΔΡΟΥ,1201,0,0,0,0,2020-12-30T00:00:00,0,0,0,0
ΑΡΓΟΛΙΔΑΣ,1001,0,0,0,0,2020-12-30T00:00:00,0,0,0,0
ΑΡΚΑΔΙΑΣ,1002,0,0,0,0,2020-12-30T00:00:00,0,0,0,0
ΑΡΤΑΣ,401,0,0,0,0,2020-12-30T00:00:00,0,0,0,0
ΑΧΑΪΑΣ,702,97,0,-17,97,2020-12-30T00:00:00,211,211,0,211
ΒΟΙΩΤΙΑΣ,801,0,0,0,0,2020-12-30T00:00:00,0,0,0,0
ΒΟΡΕΙΟΥ ΤΟΜΕΑ ΑΘΗΝΩΝ,902,0,0,0,0,2020-12-30T00:00:00,0,0,0,0
ΓΡΕΒΕΝΩΝ,301,0,0,0,0,2020-12-30T00:00:00,0,0,0,0
ΔΡΑΜΑΣ,101,0,0,0,0,2020-12-30T00:00:00,0,0,0,0
ΔΥΤΙΚΗΣ ΑΤΤΙΚΗΣ,903,49,0,4,49,2020-12-30T00:00:00,199,199,0,199
ΔΥΤΙΚΟΥ ΤΟΜΕΑ ΑΘΗΝΩΝ,904,40,0,-15,40,2020-12-30T00:00:00,200,200,0,200
ΕΒΡΟΥ,102,0,0,0,0,2020-12-30T00:00:00,0,0,0,0
ΕΥΒΟΙΑΣ,802,0,0,0,0,2020-12-30T00:00:00,0,0,0,0
ΕΥΡΥΤΑΝΙΑΣ,803,0,0,0,0,2020-12-30T00:00:00,0,0,0,0
ΖΑΚΥΝΘΟΥ,601,0,0,0,0,2020-12-30T00:00:00,0,0,0,0
ΗΛΕΙΑΣ,703,0,0,0,0,2020-12-30T00:00:00,0,0,0,0
ΗΜΑΘΙΑΣ,201,0,0,0,0,2020-12-30T00:00:00,0,0,0,0
ΗΡΑΚΛΕΙΟΥ,1301,0,0,0,0,2020-12-30T00:00:00,0,0,0,0
ΘΑΣΟΥ,103,0,0,0,0,2020-12-30T00:00:00,0,0,0,0
ΘΕΣΠΡΩΤΙΑΣ,402,0,0,0,0,2020-12-30T00:00:00,0,0,0,0
ΘΕΣΣΑΛΟΝΙΚΗΣ,202,79,0,21,79,2020-12-30T00:00:00,137,137,0,137
ΘΗΡΑΣ,1202,0,0,0,0,2020-12-30T00:00:00,0,0,0,0
ΙΘΑΚΗΣ,602,0,0,0,0,2020-12-30T00:00:00,0,0,0,0
ΙΚΑΡΙΑΣ,1101,0,0,0,0,2020-12-30T00:00:00,0,0,0,0
ΙΩΑΝΝΙΝΩΝ,403,100,0,23,100,2020-12-30T00:00:00,177,177,0,177
ΚΑΒΑΛΑΣ,104,0,0,0,0,2020-12-30T00:00:00,0,0,0,0
ΚΑΛΥΜΝΟΥ,1203,0,0,0,0,2020-12-30T00:00:00,0,0,0,0
ΚΑΡΔΙΤΣΑΣ,501,0,0,0,0,2020-12-30T00:00:00,0,0,0,0
ΚΑΡΠΑΘΟΥ,1204,0,0,0,0,2020-12-30T00:00:00,0,0,0,0
ΚΑΣΤΟΡΙΑΣ,302,0,0,0,0,2020-12-30T00:00:00,0,0,0,0
ΚΕΑΣ-ΚΥΘΝΟΥ,1205,0,0,0,0,2020-12-30T00:00:00,0,0,0,0
ΚΕΝΤΡΙΚΟΥ ΤΟΜΕΑ ΑΘΗΝΩΝ,905,95,0,-25,95,2020-12-30T00:00:00,362,362,0,362
ΚΕΡΚΥΡΑΣ,603,0,0,0,0,2020-12-30T00:00:00,0,0,0,0
ΚΕΦΑΛΛΗΝΙΑΣ,604,0,0,0,0,2020-12-30T00:00:00,0,0,0,0
ΚΙΛΚΙΣ,203,0,0,0,0,2020-12-30T00:00:00,0,0,0,0
ΚΟΖΑΝΗΣ,303,0,0,0,0,2020-12-30T00:00:00,0,0,0,0
ΚΟΡΙΝΘΙΑΣ,1003,0,0,0,0,2020-12-30T00:00:00,0,0,0,0
ΚΩ,1206,0,0,0,0,2020-12-30T00:00:00,0,0,0,0
ΛΑΚΩΝΙΑΣ,1004,0,0,0,0,2020-12-30T00:00:00,0,0,0,0
ΛΑΡΙΣΑΣ,502,145,0,40,145,2020-12-30T00:00:00,250,250,0,250
ΛΑΣΙΘΙΟΥ,1302,0,0,0,0,2020-12-30T00:00:00,0,0,0,0
ΛΕΣΒΟΥ,1102,0,0,0,0,2020-12-30T00:00:00,0,0,0,0
ΛΕΥΚΑΔΑΣ,605,0,0,0,0,2020-12-30T00:00:00,0,0,0,0
ΛΗΜΝΟΥ,1103,0,0,0,0,2020-12-30T00:00:00,0,0,0,0
ΜΑΓΝΗΣΙΑΣ,503,0,0,0,0,2020-12-30T00:00:00,0,0,0,0
ΜΕΣΣΗΝΙΑΣ,1005,0,0,0,0,2020-12-30T00:00:00,0,0,0,0
ΜΗΛΟΥ,1207,0,0,0,0,2020-12-30T00:00:00,0,0,0,0
ΜΥΚΟΝΟΥ,1208,0,0,0,0,2020-12-30T00:00:00,0,0,0,0
ΝΑΞΟΥ,1209,0,0,0,0,2020-12-30T00:00:00,0,0,0,0
ΝΗΣΩΝ,906,0,0,0,0,2020-12-30T00:00:00,0,0,0,0
ΝΟΤΙΟΥ ΤΟΜΕΑ ΑΘΗΝΩΝ,907,0,0,0,0,2020-12-30T00:00:00,0,0,0,0
ΞΑΝΘΗΣ,105,0,0,0,0,2020-12-30T00:00:00,0,0,0,0
ΠΑΡΟΥ,1210,0,0,0,0,2020-12-30T00:00:00,0,0,0,0
ΠΕΙΡΑΙΩΣ,908,0,0,0,0,2020-12-30T00:00:00,0,0,0,0
ΠΕΛΛΑΣ,204,0,0,0,0,2020-12-30T00:00:00,0,0,0,0
ΠΙΕΡΙΑΣ,205,0,0,0,0,2020-12-30T00:00:00,0,0,0,0
ΠΡΕΒΕΖΑΣ,404,0,0,0,0,2020-12-30T00:00:00,0,0,0,0
ΡΕΘΥΜΝΟΥ,1303,0,0,0,0,2020-12-30T00:00:00,0,0,0,0
ΡΟΔΟΠΗΣ,106,0,0,0,0,2020-12-30T00:00:00,0,0,0,0
ΡΟΔΟΥ,1211,0,0,0,0,2020-12-30T00:00:00,0,0,0,0
ΣΑΜΟΥ,1104,0,0,0,0,2020-12-30T00:00:00,0,0,0,0
ΣΕΡΡΩΝ,206,0,0,0,0,2020-12-30T00:00:00,0,0,0,0
ΣΠΟΡΑΔΩΝ,504,0,0,0,0,2020-12-30T00:00:00,0,0,0,0
ΣΥΡΟΥ,1212,0,0,0,0,2020-12-30T00:00:00,0,0,0,0
ΤΗΝΟΥ,1213,0,0,0,0,2020-12-30T00:00:00,0,0,0,0
ΤΡΙΚΑΛΩΝ,505,0,0,0,0,2020-12-30T00:00:00,0,0,0,0
ΦΘΙΩΤΙΔΑΣ,804,0,0,0,0,2020-12-30T00:00:00,0,0,0,0
ΦΛΩΡΙΝΑΣ,304,0,0,0,0,2020-12-30T00:00:00,0,0,0,0
ΦΩΚΙΔΑΣ,805,0,0,0,0,2020-12-30T00:00:00,0,0,0,0
ΧΑΛΚΙΔΙΚΗΣ,207,0,0,0,0,2020-12-30T00:00:00,0,0,0,0
ΧΑΝΙΩΝ,1304,0,0,0,0,2020-12-30T00:00:00,0,0,0,0
ΧΙΟΥ,1105,0,0,0,0,2020-12-30T00:00:00,0,0,0,0
ΑΙΤΩΛΟΑΚΑΡΝΑΝΙΑΣ,701,70,0,20,70,2021-01-07T00:00:00,220,220,0,220
ΑΝΑΤΟΛΙΚΗΣ ΑΤΤΙΚΗΣ,901,136,0,76,136,2021-01-07T00:00:00,702,702,0,702
ΑΝΔΡΟΥ,1201,0,0,0,0,2021-01-07T00:00:00,0,0,0,0
ΑΡΓΟΛΙΔΑΣ,1001,0,0,0,0,2021-01-07T00:00:00,0,0,0,0
ΑΡΚΑΔΙΑΣ,1002,70,0,70,70,2021-01-07T00:00:00,70,70,0,70
ΑΡΤΑΣ,401,50,0,35,50,2021-01-07T00:00:00,240,240,0,240
ΑΧΑΪΑΣ,702,165,0,125,165,2021-01-07T00:00:00,1421,1421,0,1421
ΒΟΙΩΤΙΑΣ,801,0,0,0,0,2021-01-07T00:00:00,0,0,0,0
ΒΟΡΕΙΟΥ ΤΟΜΕΑ ΑΘΗΝΩΝ,902,576,0,137,576,2021-01-07T00:00:00,2334,2334,0,2334
ΓΡΕΒΕΝΩΝ,301,0,0,0,0,2021-01-07T00:00:00,0,0,0,0
ΔΡΑΜΑΣ,101,0,0,0,0,2021-01-07T00:00:00,0,0,0,0
ΔΥΤΙΚΗΣ ΑΤΤΙΚΗΣ,903,60,0,60,60,2021-01-07T00:00:00,399,399,0,399
ΔΥΤΙΚΟΥ ΤΟΜΕΑ ΑΘΗΝΩΝ,904,201,0,41,201,2021-01-07T00:00:00,1046,1046,0,1046
ΕΒΡΟΥ,102,0,0,0,0,2021-01-07T00:00:00,0,0,0,0
ΕΥΒΟΙΑΣ,802,50,0,50,50,2021-01-07T00:00:00,50,50,0,50
ΕΥΡΥΤΑΝΙΑΣ,803,0,0,0,0,2021-01-07T00:00:00,0,0,0,0
ΖΑΚΥΝΘΟΥ,601,0,0,0,0,2021-01-07T00:00:00,0,0,0,0
ΗΛΕΙΑΣ,703,80,0,80,80,2021-01-07T00:00:00,80,80,0,80
ΗΜΑΘΙΑΣ,201,40,0,10,40,2021-01-07T00:00:00,199,199,0,199
ΗΡΑΚΛΕΙΟΥ,1301,120,0,0,120,2021-01-07T00:00:00,496,496,0,496
ΘΑΣΟΥ,103,0,0,0,0,2021-01-07T00:00:00,0,0,0,0
ΘΕΣΠΡΩΤΙΑΣ,402,40,0,40,40,2021-01-07T00:00:00,40,40,0,40
ΘΕΣΣΑΛΟΝΙΚΗΣ,202,900,0,350,900,2021-01-07T00:00:00,4358,4358,0,4358
ΘΗΡΑΣ,1202,0,0,0,0,2021-01-07T00:00:00,0,0,0,0
ΙΘΑΚΗΣ,602,0,0,0,0,2021-01-07T00:00:00,0,0,0,0
ΙΚΑΡΙΑΣ,1101,0,0,0,0,2021-01-07T00:00:00,0,0,0,0
ΙΩΑΝΝΙΝΩΝ,403,190,0,30,190,2021-01-07T00:00:00,1253,1253,0,1253
ΚΑΒΑΛΑΣ,104,0,0,0,0,2021-01-07T00:00:00,0,0,0,0
ΚΑΛΥΜΝΟΥ,1203,0,0,0,0,2021-01-07T00:00:00,0,0,0,0
ΚΑΡΔΙΤΣΑΣ,501,100,0,-5,100,2021-01-07T00:00:00,445,445,0,445
ΚΑΡΠΑΘΟΥ,1204,0,0,0,0,2021-01-07T00:00:00,0,0,0,0
ΚΑΣΤΟΡΙΑΣ,302,0,0,0,0,2021-01-07T00:00:00,0,0,0,0
ΚΕΑΣ-ΚΥΘΝΟΥ,1205,0,0,0,0,2021-01-07T00:00:00,0,0,0,0
ΚΕΝΤΡΙΚΟΥ ΤΟΜΕΑ ΑΘΗΝΩΝ,905,1856,0,347,1856,2021-01-07T00:00:00,8694,8694,0,8694
ΚΕΡΚΥΡΑΣ,603,0,0,0,0,2021-01-07T00:00:00,0,0,0,0
ΚΕΦΑΛΛΗΝΙΑΣ,604,0,0,0,0,2021-01-07T00:00:00,0,0,0,0
ΚΙΛΚΙΣ,203,0,0,0,0,2021-01-07T00:00:00,0,0,0,0
ΚΟΖΑΝΗΣ,303,80,0,-10,80,2021-01-07T00:00:00,398,398,0,398
ΚΟΡΙΝΘΙΑΣ,1003,20,0,-30,20,2021-01-07T00:00:00,170,170,0,170
ΚΩ,1206,0,0,0,0,2021-01-07T00:00:00,0,0,0,0
ΛΑΚΩΝΙΑΣ,1004,115,0,115,115,2021-01-07T00:00:00,115,115,0,115
ΛΑΡΙΣΑΣ,502,225,0,125,225,2021-01-07T00:00:00,1276,1276,0,1276
ΛΑΣΙΘΙΟΥ,1302,0,0,0,0,2021-01-07T00:00:00,0,0,0,0
ΛΕΣΒΟΥ,1102,0,0,0,0,2021-01-07T00:00:00,0,0,0,0
ΛΕΥΚΑΔΑΣ,605,0,0,0,0,2021-01-07T00:00:00,0,0,0,0
ΛΗΜΝΟΥ,1103,0,0,0,0,2021-01-07T00:00:00,0,0,0,0
ΜΑΓΝΗΣΙΑΣ,503,0,0,0,0,2021-01-07T00:00:00,0,0,0,0
ΜΕΣΣΗΝΙΑΣ,1005,45,0,45,45,2021-01-07T00:00:00,45,45,0,45
ΜΗΛΟΥ,1207,0,0,0,0,2021-01-07T00:00:00,0,0,0,0
ΜΥΚΟΝΟΥ,1208,0,0,0,0,2021-01-07T00:00:00,0,0,0,0
ΝΑΞΟΥ,1209,0,0,0,0,2021-01-07T00:00:00,0,0,0,0
ΝΗΣΩΝ,906,0,0,0,0,2021-01-07T00:00:00,0,0,0,0
ΝΟΤΙΟΥ ΤΟΜΕΑ ΑΘΗΝΩΝ,907,0,0,0,0,2021-01-07T00:00:00,0,0,0,0
ΞΑΝΘΗΣ,105,10,0,10,10,2021-01-07T00:00:00,10,10,0,10
ΠΑΡΟΥ,1210,0,0,0,0,2021-01-07T00:00:00,0,0,0,0
ΠΕΙΡΑΙΩΣ,908,148,0,51,148,2021-01-07T00:00:00,597,597,0,597
ΠΕΛΛΑΣ,204,89,0,-11,89,2021-01-07T00:00:00,400,400,0,400
ΠΙΕΡΙΑΣ,205,19,0,-51,19,2021-01-07T00:00:00,278,278,0,278
ΠΡΕΒΕΖΑΣ,404,64,0,64,64,2021-01-07T00:00:00,64,64,0,64
ΡΕΘΥΜΝΟΥ,1303,0,0,0,0,2021-01-07T00:00:00,0,0,0,0
ΡΟΔΟΠΗΣ,106,0,0,0,0,2021-01-07T00:00:00,0,0,0,0
ΡΟΔΟΥ,1211,0,0,0,0,2021-01-07T00:00:00,0,0,0,0
ΣΑΜΟΥ,1104,0,0,0,0,2021-01-07T00:00:00,0,0,0,0
ΣΕΡΡΩΝ,206,0,0,0,0,2021-01-07T00:00:00,0,0,0,0
ΣΠΟΡΑΔΩΝ,504,0,0,0,0,2021-01-07T00:00:00,0,0,0,0
ΣΥΡΟΥ,1212,0,0,0,0,2021-01-07T00:00:00,0,0,0,0
ΤΗΝΟΥ,1213,0,0,0,0,2021-01-07T00:00:00,0,0,0,0
ΤΡΙΚΑΛΩΝ,505,115,0,30,115,2021-01-07T00:00:00,400,400,0,400
ΦΘΙΩΤΙΔΑΣ,804,45,0,45,45,2021-01-07T00:00:00,45,45,0,45
ΦΛΩΡΙΝΑΣ,304,0,0,0,0,2021-01-07T00:00:00,0,0,0,0
ΦΩΚΙΔΑΣ,805,0,0,0,0,2021-01-07T00:00:00,0,0,0,0
ΧΑΛΚΙΔΙΚΗΣ,207,0,0,0,0,2021-01-07T00:00:00,0,0,0,0
ΧΑΝΙΩΝ,1304,150,0,-5,150,2021-01-07T00:00:00,600,600,0,600
ΧΙΟΥ,1105,0,0,0,0,2021-01-07T00:00:00,0,0,0,0
ΑΙΤΩΛΟΑΚΑΡΝΑΝΙΑΣ,701,105,0,35,105,2021-01-08T00:00:00,325,325,0,325
ΑΝΑΤΟΛΙΚΗΣ ΑΤΤΙΚΗΣ,901,5,0,-131,5,2021-01-08T00:00:00,707,707,0,707
ΑΝΔΡΟΥ,1201,0,0,0,0,2021-01-08T00:00:00,0,0,0,0
ΑΡΓΟΛΙΔΑΣ,1001,110,0,110,110,2021-01-08T00:00:00,110,110,0,110
ΑΡΚΑΔΙΑΣ,1002,184,0,114,184,2021-01-08T00:00:00,254,254,0,254
ΑΡΤΑΣ,401,90,0,40,90,2021-01-08T00:00:00,330,330,0,330
ΑΧΑΪΑΣ,702,130,0,-35,130,2021-01-08T00:00:00,1551,1551,0,1551
ΒΟΙΩΤΙΑΣ,801,125,0,125,125,2021-01-08T00:00:00,125,125,0,125
ΒΟΡΕΙΟΥ ΤΟΜΕΑ ΑΘΗΝΩΝ,902,844,0,268,844,2021-01-08T00:00:00,3178,3178,0,3178
ΓΡΕΒΕΝΩΝ,301,45,0,45,45,2021-01-08T00:00:00,45,45,0,45
ΔΡΑΜΑΣ,101,100,0,100,100,2021-01-08T00:00:00,100,100,0,100
ΔΥΤΙΚΗΣ ΑΤΤΙΚΗΣ,903,25,0,-35,25,2021-01-08T00:00:00,424,424,0,424
ΔΥΤΙΚΟΥ ΤΟΜΕΑ ΑΘΗΝΩΝ,904,409,0,208,409,2021-01-08T00:00:00,1455,1455,0,1455
ΕΒΡΟΥ,102,105,0,105,105,2021-01-08T00:00:00,105,105,0,105
ΕΥΒΟΙΑΣ,802,185,0,135,185,2021-01-08T00:00:00,235,235,0,235
ΕΥΡΥΤΑΝΙΑΣ,803,50,0,50,50,2021-01-08T00:00:00,50,50,0,50
ΖΑΚΥΝΘΟΥ,601,0,0,0,0,2021-01-08T00:00:00,0,0,0,0
ΗΛΕΙΑΣ,703,195,0,115,195,2021-01-08T00:00:00,275,275,0,275
ΗΜΑΘΙΑΣ,201,100,0,60,100,2021-01-08T00:00:00,299,299,0,299
ΗΡΑΚΛΕΙΟΥ,1301,231,0,111,231,2021-01-08T00:00:00,727,727,0,727
ΘΑΣΟΥ,103,0,0,0,0,2021-01-08T00:00:00,0,0,0,0
ΘΕΣΠΡΩΤΙΑΣ,402,85,0,45,85,2021-01-08T00:00:00,125,125,0,125
ΘΕΣΣΑΛΟΝΙΚΗΣ,202,840,0,-60,840,2021-01-08T00:00:00,5198,5198,0,5198
ΘΗΡΑΣ,1202,0,0,0,0,2021-01-08T00:00:00,0,0,0,0
ΙΘΑΚΗΣ,602,0,0,0,0,2021-01-08T00:00:00,0,0,0,0
ΙΚΑΡΙΑΣ,1101,0,0,0,0,2021-01-08T00:00:00,0,0,0,0
ΙΩΑΝΝΙΝΩΝ,403,220,0,30,220,2021-01-08T00:00:00,1473,1473,0,1473
ΚΑΒΑΛΑΣ,104,100,0,100,100,2021-01-08T00:00:00,100,100,0,100
ΚΑΛΥΜΝΟΥ,1203,0,0,0,0,2021-01-08T00:00:00,0,0,0,0
ΚΑΡΔΙΤΣΑΣ,501,99,0,-1,99,2021-01-08T00:00:00,544,544,0,544
ΚΑΡΠΑΘΟΥ,1204,0,0,0,0,2021-01-08T00:00:00,0,0,0,0
ΚΑΣΤΟΡΙΑΣ,302,60,0,60,60,2021-01-08T00:00:00,60,60,0,60
ΚΕΑΣ-ΚΥΘΝΟΥ,1205,0,0,0,0,2021-01-08T00:00:00,0,0,0,0
ΚΕΝΤΡΙΚΟΥ ΤΟΜΕΑ ΑΘΗΝΩΝ,905,1829,0,-27,1829,2021-01-08T00:00:00,10523,10523,0,10523
ΚΕΡΚΥΡΑΣ,603,0,0,0,0,2021-01-08T00:00:00,0,0,0,0
ΚΕΦΑΛΛΗΝΙΑΣ,604,0,0,0,0,2021-01-08T00:00:00,0,0,0,0
ΚΙΛΚΙΣ,203,105,0,105,105,2021-01-08T00:00:00,105,105,0,105
ΚΟΖΑΝΗΣ,303,50,0,-30,50,2021-01-08T00:00:00,448,448,0,448
ΚΟΡΙΝΘΙΑΣ,1003,55,0,35,55,2021-01-08T00:00:00,225,225,0,225
ΚΩ,1206,0,0,0,0,2021-01-08T00:00:00,0,0,0,0
ΛΑΚΩΝΙΑΣ,1004,150,0,35,150,2021-01-08T00:00:00,265,265,0,265
ΛΑΡΙΣΑΣ,502,165,0,-60,165,2021-01-08T00:00:00,1441,1441,0,1441
ΛΑΣΙΘΙΟΥ,1302,184,0,184,184,2021-01-08T00:00:00,184,184,0,184
ΛΕΣΒΟΥ,1102,0,0,0,0,2021-01-08T00:00:00,0,0,0,0
ΛΕΥΚΑΔΑΣ,605,0,0,0,0,2021-01-08T00:00:00,0,0,0,0
ΛΗΜΝΟΥ,1103,0,0,0,0,2021-01-08T00:00:00,0,0,0,0
ΜΑΓΝΗΣΙΑΣ,503,94,0,94,94,2021-01-08T00:00:00,94,94,0,94
ΜΕΣΣΗΝΙΑΣ,1005,205,0,160,205,2021-01-08T00:00:00,250,250,0,250
ΜΗΛΟΥ,1207,0,0,0,0,2021-01-08T00:00:00,0,0,0,0
ΜΥΚΟΝΟΥ,1208,0,0,0,0,2021-01-08T00:00:00,0,0,0,0
ΝΑΞΟΥ,1209,0,0,0,0,2021-01-08T00:00:00,0,0,0,0
ΝΗΣΩΝ,906,0,0,0,0,2021-01-08T00:00:00,0,0,0,0
ΝΟΤΙΟΥ ΤΟΜΕΑ ΑΘΗΝΩΝ,907,0,0,0,0,2021-01-08T00:00:00,0,0,0,0
ΞΑΝΘΗΣ,105,110,0,100,110,2021-01-08T00:00:00,120,120,0,120
ΠΑΡΟΥ,1210,0,0,0,0,2021-01-08T00:00:00,0,0,0,0
ΠΕΙΡΑΙΩΣ,908,456,0,308,456,2021-01-08T00:00:00,1053,1053,0,1053
ΠΕΛΛΑΣ,204,70,0,-19,70,2021-01-08T00:00:00,470,470,0,470
ΠΙΕΡΙΑΣ,205,30,0,11,30,2021-01-08T00:00:00,308,308,0,308
ΠΡΕΒΕΖΑΣ,404,104,0,40,104,2021-01-08T00:00:00,168,168,0,168
ΡΕΘΥΜΝΟΥ,1303,50,0,50,50,2021-01-08T00:00:00,50,50,0,50
ΡΟΔΟΠΗΣ,106,50,0,50,50,2021-01-08T00:00:00,50,50,0,50
ΡΟΔΟΥ,1211,0,0,0,0,2021-01-08T00:00:00,0,0,0,0
ΣΑΜΟΥ,1104,0,0,0,0,2021-01-08T00:00:00,0,0,0,0
ΣΕΡΡΩΝ,206,100,0,100,100,2021-01-08T00:00:00,100,100,0,100
ΣΠΟΡΑΔΩΝ,504,0,0,0,0,2021-01-08T00:00:00,0,0,0,0
ΣΥΡΟΥ,1212,0,0,0,0,2021-01-08T00:00:00,0,0,0,0
ΤΗΝΟΥ,1213,0,0,0,0,2021-01-08T00:00:00,0,0,0,0
ΤΡΙΚΑΛΩΝ,505,90,0,-25,90,2021-01-08T00:00:00,490,490,0,490
ΦΘΙΩΤΙΔΑΣ,804,140,0,95,140,2021-01-08T00:00:00,185,185,0,185
ΦΛΩΡΙΝΑΣ,304,78,0,78,78,2021-01-08T00:00:00,78,78,0,78
ΦΩΚΙΔΑΣ,805,50,0,50,50,2021-01-08T00:00:00,50,50,0,50
ΧΑΛΚΙΔΙΚΗΣ,207,50,0,50,50,2021-01-08T00:00:00,50,50,0,50
ΧΑΝΙΩΝ,1304,170,0,20,170,2021-01-08T00:00:00,770,770,0,770
ΧΙΟΥ,1105,0,0,0,0,2021-01-08T00:00:00,0,0,0,0
ΑΙΤΩΛΟΑΚΑΡΝΑΝΙΑΣ,701,80,0,-25,80,2021-01-09T00:00:00,405,405,0,405
ΑΝΑΤΟΛΙΚΗΣ ΑΤΤΙΚΗΣ,901,0,0,-5,0,2021-01-09T00:00:00,707,707,0,707
ΑΝΔΡΟΥ,1201,0,0,0,0,2021-01-09T00:00:00,0,0,0,0
ΑΡΓΟΛΙΔΑΣ,1001,90,0,-20,90,2021-01-09T00:00:00,200,200,0,200
ΑΡΚΑΔΙΑΣ,1002,86,0,-98,86,2021-01-09T00:00:00,340,340,0,340
ΑΡΤΑΣ,401,70,0,-20,70,2021-01-09T00:00:00,400,400,0,400
ΑΧΑΪΑΣ,702,100,0,-30,100,2021-01-09T00:00:00,1651,1651,0,1651
ΒΟΙΩΤΙΑΣ,801,70,0,-55,70,2021-01-09T00:00:00,195,195,0,195
ΒΟΡΕΙΟΥ ΤΟΜΕΑ ΑΘΗΝΩΝ,902,40,0,-804,40,2021-01-09T00:00:00,3218,3218,0,3218
ΓΡΕΒΕΝΩΝ,301,45,0,0,45,2021-01-09T00:00:00,90,90,0,90
ΔΡΑΜΑΣ,101,110,0,10,110,2021-01-09T00:00:00,210,210,0,210
ΔΥΤΙΚΗΣ ΑΤΤΙΚΗΣ,903,0,0,-25,0,2021-01-09T00:00:00,424,424,0,424
ΔΥΤΙΚΟΥ ΤΟΜΕΑ ΑΘΗΝΩΝ,904,344,0,-65,344,2021-01-09T00:00:00,1799,1799,0,1799
ΕΒΡΟΥ,102,128,0,23,128,2021-01-09T00:00:00,233,233,0,233
ΕΥΒΟΙΑΣ,802,120,0,-65,120,2021-01-09T00:00:00,355,355,0,355
ΕΥΡΥΤΑΝΙΑΣ,803,35,0,-15,35,2021-01-09T00:00:00,85,85,0,85
ΖΑΚΥΝΘΟΥ,601,0,0,0,0,2021-01-09T00:00:00,0,0,0,0
ΗΛΕΙΑΣ,703,105,0,-90,105,2021-01-09T00:00:00,380,380,0,380
ΗΜΑΘΙΑΣ,201,100,0,0,100,2021-01-09T00:00:00,399,399,0,399
ΗΡΑΚΛΕΙΟΥ,1301,219,0,-12,219,2021-01-09T00:00:00,946,946,0,946
ΘΑΣΟΥ,103,0,0,0,0,2021-01-09T00:00:00,0,0,0,0
ΘΕΣΠΡΩΤΙΑΣ,402,55,0,-30,55,2021-01-09T00:00:00,180,180,0,180
ΘΕΣΣΑΛΟΝΙΚΗΣ,202,490,0,-350,490,2021-01-09T00:00:00,5688,5688,0,5688
ΘΗΡΑΣ,1202,0,0,0,0,2021-01-09T00:00:00,0,0,0,0
ΙΘΑΚΗΣ,602,0,0,0,0,2021-01-09T00:00:00,0,0,0,0
ΙΚΑΡΙΑΣ,1101,0,0,0,0,2021-01-09T00:00:00,0,0,0,0
ΙΩΑΝΝΙΝΩΝ,403,135,0,-85,135,2021-01-09T00:00:00,1608,1608,0,1608
ΚΑΒΑΛΑΣ,104,120,0,20,120,2021-01-09T00:00:00,220,220,0,220
ΚΑΛΥΜΝΟΥ,1203,0,0,0,0,2021-01-09T00:00:00,0,0,0,0
ΚΑΡΔΙΤΣΑΣ,501,0,0,-99,0,2021-01-09T00:00:00,544,544,0,544
ΚΑΡΠΑΘΟΥ,1204,0,0,0,0,2021-01-09T00:00:00,0,0,0,0
ΚΑΣΤΟΡΙΑΣ,302,54,0,-6,54,2021-01-09T00:00:00,114,114,0,114
ΚΕΑΣ-ΚΥΘΝΟΥ,1205,0,0,0,0,2021-01-09T00:00:00,0,0,0,0
ΚΕΝΤΡΙΚΟΥ ΤΟΜΕΑ ΑΘΗΝΩΝ,905,869,0,-960,869,2021-01-09T00:00:00,11392,11392,0,11392
ΚΕΡΚΥΡΑΣ,603,0,0,0,0,2021-01-09T00:00:00,0,0,0,0
ΚΕΦΑΛΛΗΝΙΑΣ,604,0,0,0,0,2021-01-09T00:00:00,0,0,0,0
ΚΙΛΚΙΣ,203,50,0,-55,50,2021-01-09T00:00:00,155,155,0,155
ΚΟΖΑΝΗΣ,303,50,0,0,50,2021-01-09T00:00:00,498,498,0,498
ΚΟΡΙΝΘΙΑΣ,1003,55,0,0,55,2021-01-09T00:00:00,280,280,0,280
ΚΩ,1206,0,0,0,0,2021-01-09T00:00:00,0,0,0,0
ΛΑΚΩΝΙΑΣ,1004,119,0,-31,119,2021-01-09T00:00:00,384,384,0,384
ΛΑΡΙΣΑΣ,502,40,0,-125,40,2021-01-09T00:00:00,1481,1481,0,1481
ΛΑΣΙΘΙΟΥ,1302,95,0,-89,95,2021-01-09T00:00:00,279,279,0,279
ΛΕΣΒΟΥ,1102,0,0,0,0,2021-01-09T00:00:00,0,0,0,0
ΛΕΥΚΑΔΑΣ,605,0,0,0,0,2021-01-09T00:00:00,0,0,0,0
ΛΗΜΝΟΥ,1103,0,0,0,0,2021-01-09T00:00:00,0,0,0,0
ΜΑΓΝΗΣΙΑΣ,503,95,0,1,95,2021-01-09T00:00:00,189,189,0,189
ΜΕΣΣΗΝΙΑΣ,1005,138,0,-67,138,2021-01-09T00:00:00,388,388,0,388
ΜΗΛΟΥ,1207,0,0,0,0,2021-01-09T00:00:00,0,0,0,0
ΜΥΚΟΝΟΥ,1208,0,0,0,0,2021-01-09T00:00:00,0,0,0,0
ΝΑΞΟΥ,1209,0,0,0,0,2021-01-09T00:00:00,0,0,0,0
ΝΗΣΩΝ,906,0,0,0,0,2021-01-09T00:00:00,0,0,0,0
ΝΟΤΙΟΥ ΤΟΜΕΑ ΑΘΗΝΩΝ,907,0,0,0,0,2021-01-09T00:00:00,0,0,0,0
ΞΑΝΘΗΣ,105,110,0,0,110,2021-01-09T00:00:00,230,230,0,230
ΠΑΡΟΥ,1210,0,0,0,0,2021-01-09T00:00:00,0,0,0,0
ΠΕΙΡΑΙΩΣ,908,246,0,-210,246,2021-01-09T00:00:00,1299,1299,0,1299
ΠΕΛΛΑΣ,204,20,0,-50,20,2021-01-09T00:00:00,490,490,0,490
ΠΙΕΡΙΑΣ,205,15,0,-15,15,2021-01-09T00:00:00,323,323,0,323
ΠΡΕΒΕΖΑΣ,404,57,0,-47,57,2021-01-09T00:00:00,225,225,0,225
ΡΕΘΥΜΝΟΥ,1303,50,0,0,50,2021-01-09T00:00:00,100,100,0,100
ΡΟΔΟΠΗΣ,106,50,0,0,50,2021-01-09T00:00:00,100,100,0,100
ΡΟΔΟΥ,1211,0,0,0,0,2021-01-09T00:00:00,0,0,0,0
ΣΑΜΟΥ,1104,0,0,0,0,2021-01-09T00:00:00,0,0,0,0
ΣΕΡΡΩΝ,206,100,0,0,100,2021-01-09T00:00:00,200,200,0,200
ΣΠΟΡΑΔΩΝ,504,0,0,0,0,2021-01-09T00:00:00,0,0,0,0
ΣΥΡΟΥ,1212,0,0,0,0,2021-01-09T00:00:00,0,0,0,0
ΤΗΝΟΥ,1213,0,0,0,0,2021-01-09T00:00:00,0,0,0,0
ΤΡΙΚΑΛΩΝ,505,50,0,-40,50,2021-01-09T00:00:00,540,540,0,540
ΦΘΙΩΤΙΔΑΣ,804,100,0,-40,100,2021-01-09T00:00:00,285,285,0,285
ΦΛΩΡΙΝΑΣ,304,60,0,-18,60,2021-01-09T00:00:00,138,138,0,138
ΦΩΚΙΔΑΣ,805,40,0,-10,40,2021-01-09T00:00:00,90,90,0,90
ΧΑΛΚΙΔΙΚΗΣ,207,65,0,15,65,2021-01-09T00:00:00,115,115,0,115
ΧΑΝΙΩΝ,1304,85,0,-85,85,2021-01-09T00:00:00,855,855,0,855
ΧΙΟΥ,1105,0,0,0,0,2021-01-09T00:00:00,0,0,0,0
ΑΙΤΩΛΟΑΚΑΡΝΑΝΙΑΣ,701,90,0,10,90,2021-01-10T00:00:00,495,495,0,495
ΑΝΑΤΟΛΙΚΗΣ ΑΤΤΙΚΗΣ,901,0,0,0,0,2021-01-10T00:00:00,707,707,0,707
ΑΝΔΡΟΥ,1201,0,0,0,0,2021-01-10T00:00:00,0,0,0,0
ΑΡΓΟΛΙΔΑΣ,1001,35,0,-55,35,2021-01-10T00:00:00,235,235,0,235
ΑΡΚΑΔΙΑΣ,1002,115,0,29,115,2021-01-10T00:00:00,455,455,0,455
ΑΡΤΑΣ,401,0,0,-70,0,2021-01-10T00:00:00,400,400,0,400
ΑΧΑΪΑΣ,702,0,0,-100,0,2021-01-10T00:00:00,1651,1651,0,1651
ΒΟΙΩΤΙΑΣ,801,75,0,5,75,2021-01-10T00:00:00,270,270,0,270
ΒΟΡΕΙΟΥ ΤΟΜΕΑ ΑΘΗΝΩΝ,902,162,0,122,162,2021-01-10T00:00:00,3380,3380,0,3380
ΓΡΕΒΕΝΩΝ,301,45,0,0,45,2021-01-10T00:00:00,135,135,0,135
ΔΡΑΜΑΣ,101,100,0,-10,100,2021-01-10T00:00:00,310,310,0,310
ΔΥΤΙΚΗΣ ΑΤΤΙΚΗΣ,903,0,0,0,0,2021-01-10T00:00:00,424,424,0,424
ΔΥΤΙΚΟΥ ΤΟΜΕΑ ΑΘΗΝΩΝ,904,225,0,-119,225,2021-01-10T00:00:00,2024,2024,0,2024
ΕΒΡΟΥ,102,154,0,26,154,2021-01-10T00:00:00,387,387,0,387
ΕΥΒΟΙΑΣ,802,95,0,-25,95,2021-01-10T00:00:00,450,450,0,450
ΕΥΡΥΤΑΝΙΑΣ,803,15,0,-20,15,2021-01-10T00:00:00,100,100,0,100
ΖΑΚΥΝΘΟΥ,601,0,0,0,0,2021-01-10T00:00:00,0,0,0,0
ΗΛΕΙΑΣ,703,80,0,-25,80,2021-01-10T00:00:00,460,460,0,460
ΗΜΑΘΙΑΣ,201,100,0,0,100,2021-01-10T00:00:00,499,499,0,499
ΗΡΑΚΛΕΙΟΥ,1301,210,0,-9,210,2021-01-10T00:00:00,1156,1156,0,1156
ΘΑΣΟΥ,103,0,0,0,0,2021-01-10T00:00:00,0,0,0,0
ΘΕΣΠΡΩΤΙΑΣ,402,45,0,-10,45,2021-01-10T00:00:00,225,225,0,225
ΘΕΣΣΑΛΟΝΙΚΗΣ,202,310,0,-180,310,2021-01-10T00:00:00,5998,5998,0,5998
ΘΗΡΑΣ,1202,0,0,0,0,2021-01-10T00:00:00,0,0,0,0
ΙΘΑΚΗΣ,602,0,0,0,0,2021-01-10T00:00:00,0,0,0,0
ΙΚΑΡΙΑΣ,1101,0,0,0,0,2021-01-10T00:00:00,0,0,0,0
ΙΩΑΝΝΙΝΩΝ,403,135,0,0,135,2021-01-10T00:00:00,1743,1743,0,1743
ΚΑΒΑΛΑΣ,104,120,0,0,120,2021-01-10T00:00:00,340,340,0,340
ΚΑΛΥΜΝΟΥ,1203,0,0,0,0,2021-01-10T00:00:00,0,0,0,0
ΚΑΡΔΙΤΣΑΣ,501,0,0,0,0,2021-01-10T00:00:00,544,544,0,544
ΚΑΡΠΑΘΟΥ,1204,0,0,0,0,2021-01-10T00:00:00,0,0,0,0
ΚΑΣΤΟΡΙΑΣ,302,40,0,-14,40,2021-01-10T00:00:00,154,154,0,154
ΚΕΑΣ-ΚΥΘΝΟΥ,1205,0,0,0,0,2021-01-10T00:00:00,0,0,0,0
ΚΕΝΤΡΙΚΟΥ ΤΟΜΕΑ ΑΘΗΝΩΝ,905,645,0,-224,645,2021-01-10T00:00:00,12037,12037,0,12037
ΚΕΡΚΥΡΑΣ,603,0,0,0,0,2021-01-10T00:00:00,0,0,0,0
ΚΕΦΑΛΛΗΝΙΑΣ,604,0,0,0,0,2021-01-10T00:00:00,0,0,0,0
ΚΙΛΚΙΣ,203,50,0,0,50,2021-01-10T00:00:00,205,205,0,205
ΚΟΖΑΝΗΣ,303,50,0,0,50,2021-01-10T00:00:00,548,548,0,548
ΚΟΡΙΝΘΙΑΣ,1003,0,0,-55,0,2021-01-10T00:00:00,280,280,0,280
ΚΩ,1206,0,0,0,0,2021-01-10T00:00:00,0,0,0,0
ΛΑΚΩΝΙΑΣ,1004,0,0,-119,0,2021-01-10T00:00:00,384,384,0,384
ΛΑΡΙΣΑΣ,502,50,0,10,50,2021-01-10T00:00:00,1531,1531,0,1531
ΛΑΣΙΘΙΟΥ,1302,85,0,-10,85,2021-01-10T00:00:00,364,364,0,364
ΛΕΣΒΟΥ,1102,0,0,0,0,2021-01-10T00:00:00,0,0,0,0
ΛΕΥΚΑΔΑΣ,605,0,0,0,0,2021-01-10T00:00:00,0,0,0,0
ΛΗΜΝΟΥ,1103,0,0,0,0,2021-01-10T00:00:00,0,0,0,0
ΜΑΓΝΗΣΙΑΣ,503,80,0,-15,80,2021-01-10T00:00:00,269,269,0,269
ΜΕΣΣΗΝΙΑΣ,1005,147,0,9,147,2021-01-10T00:00:00,535,535,0,535
ΜΗΛΟΥ,1207,0,0,0,0,2021-01-10T00:00:00,0,0,0,0
ΜΥΚΟΝΟΥ,1208,0,0,0,0,2021-01-10T00:00:00,0,0,0,0
ΝΑΞΟΥ,1209,0,0,0,0,2021-01-10T00:00:00,0,0,0,0
ΝΗΣΩΝ,906,0,0,0,0,2021-01-10T00:00:00,0,0,0,0
ΝΟΤΙΟΥ ΤΟΜΕΑ ΑΘΗΝΩΝ,907,0,0,0,0,2021-01-10T00:00:00,0,0,0,0
ΞΑΝΘΗΣ,105,105,0,-5,105,2021-01-10T00:00:00,335,335,0,335
ΠΑΡΟΥ,1210,0,0,0,0,2021-01-10T00:00:00,0,0,0,0
ΠΕΙΡΑΙΩΣ,908,235,0,-11,235,2021-01-10T00:00:00,1534,1534,0,1534
ΠΕΛΛΑΣ,204,20,0,0,20,2021-01-10T00:00:00,510,510,0,510
ΠΙΕΡΙΑΣ,205,5,0,-10,5,2021-01-10T00:00:00,328,328,0,328
ΠΡΕΒΕΖΑΣ,404,80,0,23,80,2021-01-10T00:00:00,305,305,0,305
ΡΕΘΥΜΝΟΥ,1303,50,0,0,50,2021-01-10T00:00:00,150,150,0,150
ΡΟΔΟΠΗΣ,106,50,0,0,50,2021-01-10T00:00:00,150,150,0,150
ΡΟΔΟΥ,1211,0,0,0,0,2021-01-10T00:00:00,0,0,0,0
ΣΑΜΟΥ,1104,0,0,0,0,2021-01-10T00:00:00,0,0,0,0
ΣΕΡΡΩΝ,206,100,0,0,100,2021-01-10T00:00:00,300,300,0,300
ΣΠΟΡΑΔΩΝ,504,0,0,0,0,2021-01-10T00:00:00,0,0,0,0
ΣΥΡΟΥ,1212,0,0,0,0,2021-01-10T00:00:00,0,0,0,0
ΤΗΝΟΥ,1213,0,0,0,0,2021-01-10T00:00:00,0,0,0,0
ΤΡΙΚΑΛΩΝ,505,55,0,5,55,2021-01-10T00:00:00,595,595,0,595
ΦΘΙΩΤΙΔΑΣ,804,100,0,0,100,2021-01-10T00:00:00,385,385,0,385
ΦΛΩΡΙΝΑΣ,304,60,0,0,60,2021-01-10T00:00:00,198,198,0,198
ΦΩΚΙΔΑΣ,805,10,0,-30,10,2021-01-10T00:00:00,100,100,0,100
ΧΑΛΚΙΔΙΚΗΣ,207,55,0,-10,55,2021-01-10T00:00:00,170,170,0,170
ΧΑΝΙΩΝ,1304,35,0,-50,35,2021-01-10T00:00:00,890,890,0,890
ΧΙΟΥ,1105,0,0,0,0,2021-01-10T00:00:00,0,0,0,0
ΑΙΤΩΛΟΑΚΑΡΝΑΝΙΑΣ,701,140,0,50,140,2021-01-11T00:00:00,635,635,0,635
ΑΝΑΤΟΛΙΚΗΣ ΑΤΤΙΚΗΣ,901,0,0,0,0,2021-01-11T00:00:00,707,707,0,707
ΑΝΔΡΟΥ,1201,0,0,0,0,2021-01-11T00:00:00,0,0,0,0
ΑΡΓΟΛΙΔΑΣ,1001,25,0,-10,25,2021-01-11T00:00:00,260,260,0,260
ΑΡΚΑΔΙΑΣ,1002,30,0,-85,30,2021-01-11T00:00:00,485,485,0,485
ΑΡΤΑΣ,401,51,0,51,51,2021-01-11T00:00:00,451,451,0,451
ΑΧΑΪΑΣ,702,10,0,10,10,2021-01-11T00:00:00,1661,1661,0,1661
ΒΟΙΩΤΙΑΣ,801,80,0,5,80,2021-01-11T00:00:00,350,350,0,350
ΒΟΡΕΙΟΥ ΤΟΜΕΑ ΑΘΗΝΩΝ,902,910,0,748,910,2021-01-11T00:00:00,4290,4290,0,4290
ΓΡΕΒΕΝΩΝ,301,45,0,0,45,2021-01-11T00:00:00,180,180,0,180
ΔΡΑΜΑΣ,101,65,0,-35,65,2021-01-11T00:00:00,375,375,0,375
ΔΥΤΙΚΗΣ ΑΤΤΙΚΗΣ,903,23,0,23,23,2021-01-11T00:00:00,447,447,0,447
ΔΥΤΙΚΟΥ ΤΟΜΕΑ ΑΘΗΝΩΝ,904,264,0,39,264,2021-01-11T00:00:00,2288,2288,0,2288
ΕΒΡΟΥ,102,143,0,-11,143,2021-01-11T00:00:00,530,530,0,530
ΕΥΒΟΙΑΣ,802,65,0,-30,65,2021-01-11T00:00:00,515,515,0,515
ΕΥΡΥΤΑΝΙΑΣ,803,20,0,5,20,2021-01-11T00:00:00,120,120,0,120
ΖΑΚΥΝΘΟΥ,601,0,0,0,0,2021-01-11T00:00:00,0,0,0,0
ΗΛΕΙΑΣ,703,55,0,-25,55,2021-01-11T00:00:00,515,515,0,515
ΗΜΑΘΙΑΣ,201,60,0,-40,60,2021-01-11T00:00:00,559,559,0,559
ΗΡΑΚΛΕΙΟΥ,1301,223,0,13,223,2021-01-11T00:00:00,1379,1379,0,1379
ΘΑΣΟΥ,103,0,0,0,0,2021-01-11T00:00:00,0,0,0,0
ΘΕΣΠΡΩΤΙΑΣ,402,0,0,-45,0,2021-01-11T00:00:00,225,225,0,225
ΘΕΣΣΑΛΟΝΙΚΗΣ,202,581,0,271,581,2021-01-11T00:00:00,6579,6579,0,6579
ΘΗΡΑΣ,1202,5,0,5,5,2021-01-11T00:00:00,5,5,0,5
ΙΘΑΚΗΣ,602,0,0,0,0,2021-01-11T00:00:00,0,0,0,0
ΙΚΑΡΙΑΣ,1101,0,0,0,0,2021-01-11T00:00:00,0,0,0,0
ΙΩΑΝΝΙΝΩΝ,403,180,0,45,180,2021-01-11T00:00:00,1923,1923,0,1923
ΚΑΒΑΛΑΣ,104,120,0,0,120,2021-01-11T00:00:00,460,460,0,460
ΚΑΛΥΜΝΟΥ,1203,0,0,0,0,2021-01-11T00:00:00,0,0,0,0
ΚΑΡΔΙΤΣΑΣ,501,0,0,0,0,2021-01-11T00:00:00,544,544,0,544
ΚΑΡΠΑΘΟΥ,1204,0,0,0,0,2021-01-11T00:00:00,0,0,0,0
ΚΑΣΤΟΡΙΑΣ,302,45,0,5,45,2021-01-11T00:00:00,199,199,0,199
ΚΕΑΣ-ΚΥΘΝΟΥ,1205,0,0,0,0,2021-01-11T00:00:00,0,0,0,0
ΚΕΝΤΡΙΚΟΥ ΤΟΜΕΑ ΑΘΗΝΩΝ,905,1019,0,374,1019,2021-01-11T00:00:00,13056,13056,0,13056
ΚΕΡΚΥΡΑΣ,603,65,0,65,65,2021-01-11T00:00:00,65,65,0,65
ΚΕΦΑΛΛΗΝΙΑΣ,604,20,0,20,20,2021-01-11T00:00:00,20,20,0,20
ΚΙΛΚΙΣ,203,60,0,10,60,2021-01-11T00:00:00,265,265,0,265
ΚΟΖΑΝΗΣ,303,50,0,0,50,2021-01-11T00:00:00,598,598,0,598
ΚΟΡΙΝΘΙΑΣ,1003,0,0,0,0,2021-01-11T00:00:00,280,280,0,280
ΚΩ,1206,0,0,0,0,2021-01-11T00:00:00,0,0,0,0
ΛΑΚΩΝΙΑΣ,1004,15,0,15,15,2021-01-11T00:00:00,399,399,0,399
ΛΑΡΙΣΑΣ,502,35,0,-15,35,2021-01-11T00:00:00,1566,1566,0,1566
ΛΑΣΙΘΙΟΥ,1302,54,0,-31,54,2021-01-11T00:00:00,418,418,0,418
ΛΕΣΒΟΥ,1102,0,0,0,0,2021-01-11T00:00:00,0,0,0,0
ΛΕΥΚΑΔΑΣ,605,30,0,30,30,2021-01-11T00:00:00,30,30,0,30
ΛΗΜΝΟΥ,1103,0,0,0,0,2021-01-11T00:00:00,0,0,0,0
ΜΑΓΝΗΣΙΑΣ,503,120,0,40,120,2021-01-11T00:00:00,389,389,0,389
ΜΕΣΣΗΝΙΑΣ,1005,25,0,-122,25,2021-01-11T00:00:00,560,560,0,560
ΜΗΛΟΥ,1207,0,0,0,0,2021-01-11T00:00:00,0,0,0,0
ΜΥΚΟΝΟΥ,1208,0,0,0,0,2021-01-11T00:00:00,0,0,0,0
ΝΑΞΟΥ,1209,0,0,0,0,2021-01-11T00:00:00,0,0,0,0
ΝΗΣΩΝ,906,0,0,0,0,2021-01-11T00:00:00,0,0,0,0
ΝΟΤΙΟΥ ΤΟΜΕΑ ΑΘΗΝΩΝ,907,25,0,25,25,2021-01-11T00:00:00,25,25,0,25
ΞΑΝΘΗΣ,105,120,0,15,120,2021-01-11T00:00:00,455,455,0,455
ΠΑΡΟΥ,1210,0,0,0,0,2021-01-11T00:00:00,0,0,0,0
ΠΕΙΡΑΙΩΣ,908,55,0,-180,55,2021-01-11T00:00:00,1589,1589,0,1589
ΠΕΛΛΑΣ,204,15,0,-5,15,2021-01-11T00:00:00,525,525,0,525
ΠΙΕΡΙΑΣ,205,25,0,20,25,2021-01-11T00:00:00,353,353,0,353
ΠΡΕΒΕΖΑΣ,404,15,0,-65,15,2021-01-11T00:00:00,320,320,0,320
ΡΕΘΥΜΝΟΥ,1303,70,0,20,70,2021-01-11T00:00:00,220,220,0,220
ΡΟΔΟΠΗΣ,106,50,0,0,50,2021-01-11T00:00:00,200,200,0,200
ΡΟΔΟΥ,1211,0,0,0,0,2021-01-11T00:00:00,0,0,0,0
ΣΑΜΟΥ,1104,0,0,0,0,2021-01-11T00:00:00,0,0,0,0
ΣΕΡΡΩΝ,206,100,0,0,100,2021-01-11T00:00:00,400,400,0,400
ΣΠΟΡΑΔΩΝ,504,0,0,0,0,2021-01-11T00:00:00,0,0,0,0
ΣΥΡΟΥ,1212,0,0,0,0,2021-01-11T00:00:00,0,0,0,0
ΤΗΝΟΥ,1213,0,0,0,0,2021-01-11T00:00:00,0,0,0,0
ΤΡΙΚΑΛΩΝ,505,25,0,-30,25,2021-01-11T00:00:00,620,620,0,620
ΦΘΙΩΤΙΔΑΣ,804,105,0,5,105,2021-01-11T00:00:00,490,490,0,490
ΦΛΩΡΙΝΑΣ,304,43,0,-17,43,2021-01-11T00:00:00,241,241,0,241
ΦΩΚΙΔΑΣ,805,5,0,-5,5,2021-01-11T00:00:00,105,105,0,105
ΧΑΛΚΙΔΙΚΗΣ,207,75,0,20,75,2021-01-11T00:00:00,245,245,0,245
ΧΑΝΙΩΝ,1304,39,0,4,39,2021-01-11T00:00:00,929,929,0,929
ΧΙΟΥ,1105,0,0,0,0,2021-01-11T00:00:00,0,0,0,0
ΑΙΤΩΛΟΑΚΑΡΝΑΝΙΑΣ,701,55,0,-85,55,2021-01-12T00:00:00,690,690,0,690
ΑΝΑΤΟΛΙΚΗΣ ΑΤΤΙΚΗΣ,901,0,0,0,0,2021-01-12T00:00:00,707,707,0,707
ΑΝΔΡΟΥ,1201,0,0,0,0,2021-01-12T00:00:00,0,0,0,0
ΑΡΓΟΛΙΔΑΣ,1001,0,0,-25,0,2021-01-12T00:00:00,260,260,0,260
ΑΡΚΑΔΙΑΣ,1002,0,0,-30,0,2021-01-12T00:00:00,485,485,0,485
ΑΡΤΑΣ,401,84,0,33,84,2021-01-12T00:00:00,535,535,0,535
ΑΧΑΪΑΣ,702,105,0,95,105,2021-01-12T00:00:00,1766,1766,0,1766
ΒΟΙΩΤΙΑΣ,801,10,0,-70,10,2021-01-12T00:00:00,360,360,0,360
ΒΟΡΕΙΟΥ ΤΟΜΕΑ ΑΘΗΝΩΝ,902,1248,0,338,1248,2021-01-12T00:00:00,5538,5538,0,5538
ΓΡΕΒΕΝΩΝ,301,15,0,-30,15,2021-01-12T00:00:00,195,195,0,195
ΔΡΑΜΑΣ,101,0,0,-65,0,2021-01-12T00:00:00,375,375,0,375
ΔΥΤΙΚΗΣ ΑΤΤΙΚΗΣ,903,25,0,2,25,2021-01-12T00:00:00,472,472,0,472
ΔΥΤΙΚΟΥ ΤΟΜΕΑ ΑΘΗΝΩΝ,904,25,0,-239,25,2021-01-12T00:00:00,2313,2313,0,2313
ΕΒΡΟΥ,102,164,0,21,164,2021-01-12T00:00:00,694,694,0,694
ΕΥΒΟΙΑΣ,802,60,0,-5,60,2021-01-12T00:00:00,575,575,0,575
ΕΥΡΥΤΑΝΙΑΣ,803,25,0,5,25,2021-01-12T00:00:00,145,145,0,145
ΖΑΚΥΝΘΟΥ,601,50,0,50,50,2021-01-12T00:00:00,50,50,0,50
ΗΛΕΙΑΣ,703,0,0,-55,0,2021-01-12T00:00:00,515,515,0,515
ΗΜΑΘΙΑΣ,201,15,0,-45,15,2021-01-12T00:00:00,574,574,0,574
ΗΡΑΚΛΕΙΟΥ,1301,229,0,6,229,2021-01-12T00:00:00,1608,1608,0,1608
ΘΑΣΟΥ,103,0,0,0,0,2021-01-12T00:00:00,0,0,0,0
ΘΕΣΠΡΩΤΙΑΣ,402,0,0,0,0,2021-01-12T00:00:00,225,225,0,225
ΘΕΣΣΑΛΟΝΙΚΗΣ,202,735,0,154,735,2021-01-12T00:00:00,7314,7314,0,7314
ΘΗΡΑΣ,1202,15,0,10,15,2021-01-12T00:00:00,20,20,0,20
ΙΘΑΚΗΣ,602,0,0,0,0,2021-01-12T00:00:00,0,0,0,0
ΙΚΑΡΙΑΣ,1101,25,0,25,25,2021-01-12T00:00:00,25,25,0,25
ΙΩΑΝΝΙΝΩΝ,403,180,0,0,180,2021-01-12T00:00:00,2103,2103,0,2103
ΚΑΒΑΛΑΣ,104,65,0,-55,65,2021-01-12T00:00:00,525,525,0,525
ΚΑΛΥΜΝΟΥ,1203,10,0,10,10,2021-01-12T00:00:00,10,10,0,10
ΚΑΡΔΙΤΣΑΣ,501,0,0,0,0,2021-01-12T00:00:00,544,544,0,544
ΚΑΡΠΑΘΟΥ,1204,10,0,10,10,2021-01-12T00:00:00,10,10,0,10
ΚΑΣΤΟΡΙΑΣ,302,40,0,-5,40,2021-01-12T00:00:00,239,239,0,239
ΚΕΑΣ-ΚΥΘΝΟΥ,1205,0,0,0,0,2021-01-12T00:00:00,0,0,0,0
ΚΕΝΤΡΙΚΟΥ ΤΟΜΕΑ ΑΘΗΝΩΝ,905,1437,0,418,1437,2021-01-12T00:00:00,14493,14493,0,14493
ΚΕΡΚΥΡΑΣ,603,100,0,35,100,2021-01-12T00:00:00,165,165,0,165
ΚΕΦΑΛΛΗΝΙΑΣ,604,90,0,70,90,2021-01-12T00:00:00,110,110,0,110
ΚΙΛΚΙΣ,203,40,0,-20,40,2021-01-12T00:00:00,305,305,0,305
ΚΟΖΑΝΗΣ,303,35,0,-15,35,2021-01-12T00:00:00,633,633,0,633
ΚΟΡΙΝΘΙΑΣ,1003,10,0,10,10,2021-01-12T00:00:00,290,290,0,290
ΚΩ,1206,0,0,0,0,2021-01-12T00:00:00,0,0,0,0
ΛΑΚΩΝΙΑΣ,1004,0,0,-15,0,2021-01-12T00:00:00,399,399,0,399
ΛΑΡΙΣΑΣ,502,115,0,80,115,2021-01-12T00:00:00,1681,1681,0,1681
ΛΑΣΙΘΙΟΥ,1302,50,0,-4,50,2021-01-12T00:00:00,468,468,0,468
ΛΕΣΒΟΥ,1102,70,0,70,70,2021-01-12T00:00:00,70,70,0,70
ΛΕΥΚΑΔΑΣ,605,50,0,20,50,2021-01-12T00:00:00,80,80,0,80
ΛΗΜΝΟΥ,1103,43,0,43,43,2021-01-12T00:00:00,43,43,0,43
ΜΑΓΝΗΣΙΑΣ,503,135,0,15,135,2021-01-12T00:00:00,524,524,0,524
ΜΕΣΣΗΝΙΑΣ,1005,0,0,-25,0,2021-01-12T00:00:00,560,560,0,560
ΜΗΛΟΥ,1207,0,0,0,0,2021-01-12T00:00:00,0,0,0,0
ΜΥΚΟΝΟΥ,1208,0,0,0,0,2021-01-12T00:00:00,0,0,0,0
ΝΑΞΟΥ,1209,35,0,35,35,2021-01-12T00:00:00,35,35,0,35
ΝΗΣΩΝ,906,25,0,25,25,2021-01-12T00:00:00,25,25,0,25
ΝΟΤΙΟΥ ΤΟΜΕΑ ΑΘΗΝΩΝ,907,89,0,64,89,2021-01-12T00:00:00,114,114,0,114
ΞΑΝΘΗΣ,105,30,0,-90,30,2021-01-12T00:00:00,485,485,0,485
ΠΑΡΟΥ,1210,0,0,0,0,2021-01-12T00:00:00,0,0,0,0
ΠΕΙΡΑΙΩΣ,908,241,0,186,241,2021-01-12T00:00:00,1830,1830,0,1830
ΠΕΛΛΑΣ,204,0,0,-15,0,2021-01-12T00:00:00,525,525,0,525
ΠΙΕΡΙΑΣ,205,20,0,-5,20,2021-01-12T00:00:00,373,373,0,373
ΠΡΕΒΕΖΑΣ,404,0,0,-15,0,2021-01-12T00:00:00,320,320,0,320
ΡΕΘΥΜΝΟΥ,1303,80,0,10,80,2021-01-12T00:00:00,300,300,0,300
ΡΟΔΟΠΗΣ,106,60,0,10,60,2021-01-12T00:00:00,260,260,0,260
ΡΟΔΟΥ,1211,110,0,110,110,2021-01-12T00:00:00,110,110,0,110
ΣΑΜΟΥ,1104,60,0,60,60,2021-01-12T00:00:00,60,60,0,60
ΣΕΡΡΩΝ,206,110,0,10,110,2021-01-12T00:00:00,510,510,0,510
ΣΠΟΡΑΔΩΝ,504,0,0,0,0,2021-01-12T00:00:00,0,0,0,0
ΣΥΡΟΥ,1212,50,0,50,50,2021-01-12T00:00:00,50,50,0,50
ΤΗΝΟΥ,1213,0,0,0,0,2021-01-12T00:00:00,0,0,0,0
ΤΡΙΚΑΛΩΝ,505,0,0,-25,0,2021-01-12T00:00:00,620,620,0,620
ΦΘΙΩΤΙΔΑΣ,804,85,0,-20,85,2021-01-12T00:00:00,575,575,0,575
ΦΛΩΡΙΝΑΣ,304,0,0,-43,0,2021-01-12T00:00:00,241,241,0,241
ΦΩΚΙΔΑΣ,805,0,0,-5,0,2021-01-12T00:00:00,105,105,0,105
ΧΑΛΚΙΔΙΚΗΣ,207,0,0,-75,0,2021-01-12T00:00:00,245,245,0,245
ΧΑΝΙΩΝ,1304,0,0,-39,0,2021-01-12T00:00:00,929,929,0,929
ΧΙΟΥ,1105,70,0,70,70,2021-01-12T00:00:00,70,70,0,70
ΑΙΤΩΛΟΑΚΑΡΝΑΝΙΑΣ,701,49,0,-6,49,2021-01-13T00:00:00,739,739,0,739
ΑΝΑΤΟΛΙΚΗΣ ΑΤΤΙΚΗΣ,901,0,0,0,0,2021-01-13T00:00:00,707,707,0,707
ΑΝΔΡΟΥ,1201,0,0,0,0,2021-01-13T00:00:00,0,0,0,0
ΑΡΓΟΛΙΔΑΣ,1001,0,0,0,0,2021-01-13T00:00:00,260,260,0,260
ΑΡΚΑΔΙΑΣ,1002,10,0,10,10,2021-01-13T00:00:00,495,495,0,495
ΑΡΤΑΣ,401,30,0,-54,30,2021-01-13T00:00:00,565,565,0,565
ΑΧΑΪΑΣ,702,189,0,84,189,2021-01-13T00:00:00,1955,1955,0,1955
ΒΟΙΩΤΙΑΣ,801,0,0,-10,0,2021-01-13T00:00:00,360,360,0,360
ΒΟΡΕΙΟΥ ΤΟΜΕΑ ΑΘΗΝΩΝ,902,2468,0,1220,2468,2021-01-13T00:00:00,8006,8006,0,8006
ΓΡΕΒΕΝΩΝ,301,0,0,-15,0,2021-01-13T00:00:00,195,195,0,195
ΔΡΑΜΑΣ,101,0,0,0,0,2021-01-13T00:00:00,375,375,0,375
ΔΥΤΙΚΗΣ ΑΤΤΙΚΗΣ,903,35,0,10,35,2021-01-13T00:00:00,507,507,0,507
ΔΥΤΙΚΟΥ ΤΟΜΕΑ ΑΘΗΝΩΝ,904,90,0,65,90,2021-01-13T00:00:00,2403,2403,0,2403
ΕΒΡΟΥ,102,141,0,-23,141,2021-01-13T00:00:00,835,835,0,835
ΕΥΒΟΙΑΣ,802,0,0,-60,0,2021-01-13T00:00:00,575,575,0,575
ΕΥΡΥΤΑΝΙΑΣ,803,0,0,-25,0,2021-01-13T00:00:00,145,145,0,145
ΖΑΚΥΝΘΟΥ,601,50,0,0,50,2021-01-13T00:00:00,100,100,0,100
ΗΛΕΙΑΣ,703,0,0,0,0,2021-01-13T00:00:00,515,515,0,515
ΗΜΑΘΙΑΣ,201,30,0,15,30,2021-01-13T00:00:00,604,604,0,604
ΗΡΑΚΛΕΙΟΥ,1301,214,0,-15,214,2021-01-13T00:00:00,1822,1822,0,1822
ΘΑΣΟΥ,103,0,0,0,0,2021-01-13T00:00:00,0,0,0,0
ΘΕΣΠΡΩΤΙΑΣ,402,0,0,0,0,2021-01-13T00:00:00,225,225,0,225
ΘΕΣΣΑΛΟΝΙΚΗΣ,202,1209,0,474,1209,2021-01-13T00:00:00,8523,8523,0,8523
ΘΗΡΑΣ,1202,0,0,-15,0,2021-01-13T00:00:00,20,20,0,20
ΙΘΑΚΗΣ,602,0,0,0,0,2021-01-13T00:00:00,0,0,0,0
ΙΚΑΡΙΑΣ,1101,5,0,-20,5,2021-01-13T00:00:00,30,30,0,30
ΙΩΑΝΝΙΝΩΝ,403,100,0,-80,100,2021-01-13T00:00:00,2203,2203,0,2203
ΚΑΒΑΛΑΣ,104,55,0,-10,55,2021-01-13T00:00:00,580,580,0,580
ΚΑΛΥΜΝΟΥ,1203,88,0,78,88,2021-01-13T00:00:00,98,98,0,98
ΚΑΡΔΙΤΣΑΣ,501,0,0,0,0,2021-01-13T00:00:00,544,544,0,544
ΚΑΡΠΑΘΟΥ,1204,5,0,-5,5,2021-01-13T00:00:00,15,15,0,15
ΚΑΣΤΟΡΙΑΣ,302,37,0,-3,37,2021-01-13T00:00:00,276,276,0,276
ΚΕΑΣ-ΚΥΘΝΟΥ,1205,0,0,0,0,2021-01-13T00:00:00,0,0,0,0
ΚΕΝΤΡΙΚΟΥ ΤΟΜΕΑ ΑΘΗΝΩΝ,905,1580,0,143,1580,2021-01-13T00:00:00,16073,16073,0,16073
ΚΕΡΚΥΡΑΣ,603,35,0,-65,35,2021-01-13T00:00:00,200,200,0,200
ΚΕΦΑΛΛΗΝΙΑΣ,604,65,0,-25,65,2021-01-13T00:00:00,175,175,0,175
ΚΙΛΚΙΣ,203,0,0,-40,0,2021-01-13T00:00:00,305,305,0,305
ΚΟΖΑΝΗΣ,303,40,0,5,40,2021-01-13T00:00:00,673,673,0,673
ΚΟΡΙΝΘΙΑΣ,1003,10,0,0,10,2021-01-13T00:00:00,300,300,0,300
ΚΩ,1206,45,0,45,45,2021-01-13T00:00:00,45,45,0,45
ΛΑΚΩΝΙΑΣ,1004,0,0,0,0,2021-01-13T00:00:00,399,399,0,399
ΛΑΡΙΣΑΣ,502,30,0,-85,30,2021-01-13T00:00:00,1711,1711,0,1711
ΛΑΣΙΘΙΟΥ,1302,41,0,-9,41,2021-01-13T00:00:00,509,509,0,509
ΛΕΣΒΟΥ,1102,85,0,15,85,2021-01-13T00:00:00,155,155,0,155
ΛΕΥΚΑΔΑΣ,605,15,0,-35,15,2021-01-13T00:00:00,95,95,0,95
ΛΗΜΝΟΥ,1103,64,0,21,64,2021-01-13T00:00:00,107,107,0,107
ΜΑΓΝΗΣΙΑΣ,503,59,0,-76,59,2021-01-13T00:00:00,583,583,0,583
ΜΕΣΣΗΝΙΑΣ,1005,0,0,0,0,2021-01-13T00:00:00,560,560,0,560
ΜΗΛΟΥ,1207,0,0,0,0,2021-01-13T00:00:00,0,0,0,0
ΜΥΚΟΝΟΥ,1208,0,0,0,0,2021-01-13T00:00:00,0,0,0,0
ΝΑΞΟΥ,1209,0,0,-35,0,2021-01-13T00:00:00,35,35,0,35
ΝΗΣΩΝ,906,0,0,-25,0,2021-01-13T00:00:00,25,25,0,25
ΝΟΤΙΟΥ ΤΟΜΕΑ ΑΘΗΝΩΝ,907,431,0,342,431,2021-01-13T00:00:00,545,545,0,545
ΞΑΝΘΗΣ,105,15,0,-15,15,2021-01-13T00:00:00,500,500,0,500
ΠΑΡΟΥ,1210,0,0,0,0,2021-01-13T00:00:00,0,0,0,0
ΠΕΙΡΑΙΩΣ,908,602,0,361,602,2021-01-13T00:00:00,2432,2432,0,2432
ΠΕΛΛΑΣ,204,0,0,0,0,2021-01-13T00:00:00,525,525,0,525
ΠΙΕΡΙΑΣ,205,10,0,-10,10,2021-01-13T00:00:00,383,383,0,383
ΠΡΕΒΕΖΑΣ,404,0,0,0,0,2021-01-13T00:00:00,320,320,0,320
ΡΕΘΥΜΝΟΥ,1303,65,0,-15,65,2021-01-13T00:00:00,365,365,0,365
ΡΟΔΟΠΗΣ,106,35,0,-25,35,2021-01-13T00:00:00,295,295,0,295
ΡΟΔΟΥ,1211,115,0,5,115,2021-01-13T00:00:00,225,225,0,225
ΣΑΜΟΥ,1104,50,0,-10,50,2021-01-13T00:00:00,110,110,0,110
ΣΕΡΡΩΝ,206,90,0,-20,90,2021-01-13T00:00:00,600,600,0,600
ΣΠΟΡΑΔΩΝ,504,0,0,0,0,2021-01-13T00:00:00,0,0,0,0
ΣΥΡΟΥ,1212,50,0,0,50,2021-01-13T00:00:00,100,100,0,100
ΤΗΝΟΥ,1213,0,0,0,0,2021-01-13T00:00:00,0,0,0,0
ΤΡΙΚΑΛΩΝ,505,15,0,15,15,2021-01-13T00:00:00,635,635,0,635
ΦΘΙΩΤΙΔΑΣ,804,40,0,-45,40,2021-01-13T00:00:00,615,615,0,615
ΦΛΩΡΙΝΑΣ,304,0,0,0,0,2021-01-13T00:00:00,241,241,0,241
ΦΩΚΙΔΑΣ,805,0,0,0,0,2021-01-13T00:00:00,105,105,0,105
ΧΑΛΚΙΔΙΚΗΣ,207,0,0,0,0,2021-01-13T00:00:00,245,245,0,245
ΧΑΝΙΩΝ,1304,0,0,0,0,2021-01-13T00:00:00,929,929,0,929
ΧΙΟΥ,1105,65,0,-5,65,2021-01-13T00:00:00,135,135,0,135
ΑΙΤΩΛΟΑΚΑΡΝΑΝΙΑΣ,701,341,115,-42,456,2021-03-04T00:00:00,8444,8444,3544,11988
ΑΝΑΤΟΛΙΚΗΣ ΑΤΤΙΚΗΣ,901,783,166,-20,949,2021-03-04T00:00:00,16275,16275,8900,25175
ΑΝΔΡΟΥ,1201,0,0,0,0,2021-03-04T00:00:00,297,297,261,558
ΑΡΓΟΛΙΔΑΣ,1001,191,15,-13,206,2021-03-04T00:00:00,5255,5255,2791,8046
ΑΡΚΑΔΙΑΣ,1002,174,14,-26,188,2021-03-04T00:00:00,5238,5238,2713,7951
ΑΡΤΑΣ,401,114,27,-10,141,2021-03-04T00:00:00,4276,4276,2888,7164
ΑΧΑΪΑΣ,702,582,41,-117,623,2021-03-04T00:00:00,15018,15018,9404,24422
ΒΟΙΩΤΙΑΣ,801,366,30,-51,396,2021-03-04T00:00:00,7248,7248,2591,9839
ΒΟΡΕΙΟΥ ΤΟΜΕΑ ΑΘΗΝΩΝ,902,3486,789,270,4275,2021-03-04T00:00:00,97157,97157,41683,138840
ΓΡΕΒΕΝΩΝ,301,73,41,-5,114,2021-03-04T00:00:00,2118,2118,1105,3223
ΔΡΑΜΑΣ,101,203,62,-3,265,2021-03-04T00:00:00,5151,5151,2995,8146
ΔΥΤΙΚΗΣ ΑΤΤΙΚΗΣ,903,354,6,-28,360,2021-03-04T00:00:00,5707,5707,2911,8618
ΔΥΤΙΚΟΥ ΤΟΜΕΑ ΑΘΗΝΩΝ,904,850,556,-40,1406,2021-03-04T00:00:00,23963,23963,15963,39926
ΕΒΡΟΥ,102,384,68,-24,452,2021-03-04T00:00:00,9525,9525,5005,14530
ΕΥΒΟΙΑΣ,802,524,26,-58,550,2021-03-04T00:00:00,10727,10727,5621,16348
ΕΥΡΥΤΑΝΙΑΣ,803,41,2,-9,43,2021-03-04T00:00:00,1194,1194,643,1837
ΖΑΚΥΝΘΟΥ,601,83,1,-11,84,2021-03-04T00:00:00,1816,1816,1276,3092
ΗΛΕΙΑΣ,703,276,35,-47,311,2021-03-04T00:00:00,6398,6398,3586,9984
ΗΜΑΘΙΑΣ,201,303,68,6,371,2021-03-04T00:00:00,7450,7450,3952,11402
ΗΡΑΚΛΕΙΟΥ,1301,612,57,-65,669,2021-03-04T00:00:00,16229,16229,9003,25232
ΘΑΣΟΥ,103,0,0,-6,0,2021-03-04T00:00:00,440,440,417,857
ΘΕΣΠΡΩΤΙΑΣ,402,193,39,-20,232,2021-03-04T00:00:00,3530,3530,2128,5658
ΘΕΣΣΑΛΟΝΙΚΗΣ,202,3049,809,-216,3858,2021-03-04T00:00:00,77655,77655,38950,116605
ΘΗΡΑΣ,1202,42,6,0,48,2021-03-04T00:00:00,538,538,331,869
ΙΘΑΚΗΣ,602,48,0,-12,48,2021-03-04T00:00:00,410,410,3,413
ΙΚΑΡΙΑΣ,1101,43,1,3,44,2021-03-04T00:00:00,1179,1179,663,1842
ΙΩΑΝΝΙΝΩΝ,403,338,124,-24,462,2021-03-04T00:00:00,12053,12053,7412,19465
ΚΑΒΑΛΑΣ,104,242,73,-1,315,2021-03-04T00:00:00,6452,6452,3985,10437
ΚΑΛΥΜΝΟΥ,1203,16,2,-6,18,2021-03-04T00:00:00,1109,1109,672,1781
ΚΑΡΔΙΤΣΑΣ,501,358,21,15,379,2021-03-04T00:00:00,8496,8496,3800,12296
ΚΑΡΠΑΘΟΥ,1204,24,0,0,24,2021-03-04T00:00:00,367,367,246,613
ΚΑΣΤΟΡΙΑΣ,302,170,34,-4,204,2021-03-04T00:00:00,3440,3440,1918,5358
ΚΕΑΣ-ΚΥΘΝΟΥ,1205,0,6,6,6,2021-03-04T00:00:00,44,44,6,50
ΚΕΝΤΡΙΚΟΥ ΤΟΜΕΑ ΑΘΗΝΩΝ,905,2969,1756,61,4725,2021-03-04T00:00:00,92603,92603,57219,149822
ΚΕΡΚΥΡΑΣ,603,290,33,17,323,2021-03-04T00:00:00,4955,4955,3017,7972
ΚΕΦΑΛΛΗΝΙΑΣ,604,134,6,-14,140,2021-03-04T00:00:00,2864,2864,1615,4479
ΚΙΛΚΙΣ,203,325,117,193,442,2021-03-04T00:00:00,5062,5062,2837,7899
ΚΟΖΑΝΗΣ,303,275,172,-9,447,2021-03-04T00:00:00,7851,7851,4094,11945
ΚΟΡΙΝΘΙΑΣ,1003,264,72,-4,336,2021-03-04T00:00:00,6236,6236,2803,9039
ΚΩ,1206,157,2,2,159,2021-03-04T00:00:00,2277,2277,915,3192
ΛΑΚΩΝΙΑΣ,1004,230,7,-25,237,2021-03-04T00:00:00,5649,5649,2763,8412
ΛΑΡΙΣΑΣ,502,364,170,9,534,2021-03-04T00:00:00,14333,14333,7202,21535
ΛΑΣΙΘΙΟΥ,1302,255,21,-61,276,2021-03-04T00:00:00,6010,6010,3881,9891
ΛΕΣΒΟΥ,1102,151,2,-44,153,2021-03-04T00:00:00,3819,3819,2548,6367
ΛΕΥΚΑΔΑΣ,605,99,6,-139,105,2021-03-04T00:00:00,2594,2594,1354,3948
ΛΗΜΝΟΥ,1103,43,5,0,48,2021-03-04T00:00:00,962,962,747,1709
ΜΑΓΝΗΣΙΑΣ,503,340,109,-61,449,2021-03-04T00:00:00,8454,8454,4161,12615
ΜΕΣΣΗΝΙΑΣ,1005,269,47,-36,316,2021-03-04T00:00:00,8272,8272,4778,13050
ΜΗΛΟΥ,1207,22,20,14,42,2021-03-04T00:00:00,325,325,224,549
ΜΥΚΟΝΟΥ,1208,0,0,0,0,2021-03-04T00:00:00,170,170,143,313
ΝΑΞΟΥ,1209,46,2,1,48,2021-03-04T00:00:00,618,618,424,1042
ΝΗΣΩΝ,906,87,33,-19,120,2021-03-04T00:00:00,2387,2387,1646,4033
ΝΟΤΙΟΥ ΤΟΜΕΑ ΑΘΗΝΩΝ,907,629,302,-36,931,2021-03-04T00:00:00,16204,16204,7368,23572
ΞΑΝΘΗΣ,105,206,25,-6,231,2021-03-04T00:00:00,4248,4248,2275,6523
ΠΑΡΟΥ,1210,0,0,-6,0,2021-03-04T00:00:00,304,304,290,594
ΠΕΙΡΑΙΩΣ,908,1097,260,-57,1357,2021-03-04T00:00:00,25309,25309,14057,39366
ΠΕΛΛΑΣ,204,356,106,-23,462,2021-03-04T00:00:00,8298,8298,4836,13134
ΠΙΕΡΙΑΣ,205,187,100,6,287,2021-03-04T00:00:00,5388,5388,3578,8966
ΠΡΕΒΕΖΑΣ,404,168,5,-6,173,2021-03-04T00:00:00,3411,3411,1090,4501
ΡΕΘΥΜΝΟΥ,1303,279,13,-12,292,2021-03-04T00:00:00,5127,5127,2365,7492
ΡΟΔΟΠΗΣ,106,139,67,-10,206,2021-03-04T00:00:00,3889,3889,1901,5790
ΡΟΔΟΥ,1211,177,69,35,246,2021-03-04T00:00:00,4779,4779,2377,7156
ΣΑΜΟΥ,1104,71,2,-20,73,2021-03-04T00:00:00,1696,1696,871,2567
ΣΕΡΡΩΝ,206,301,88,-41,389,2021-03-04T00:00:00,8294,8294,3063,11357
ΣΠΟΡΑΔΩΝ,504,2,16,-42,18,2021-03-04T00:00:00,351,351,237,588
ΣΥΡΟΥ,1212,47,1,0,48,2021-03-04T00:00:00,1042,1042,849,1891
ΤΗΝΟΥ,1213,0,0,0,0,2021-03-04T00:00:00,314,314,279,593
ΤΡΙΚΑΛΩΝ,505,287,80,-22,367,2021-03-04T00:00:00,8400,8400,4202,12602
ΦΘΙΩΤΙΔΑΣ,804,263,55,-25,318,2021-03-04T00:00:00,6678,6678,3253,9931
ΦΛΩΡΙΝΑΣ,304,190,19,2,209,2021-03-04T00:00:00,3136,3136,1625,4761
ΦΩΚΙΔΑΣ,805,64,9,-11,73,2021-03-04T00:00:00,2013,2013,960,2973
ΧΑΛΚΙΔΙΚΗΣ,207,323,65,-21,388,2021-03-04T00:00:00,5841,5841,2304,8145
ΧΑΝΙΩΝ,1304,432,79,-31,511,2021-03-04T00:00:00,10494,10494,6549,17043
ΧΙΟΥ,1105,133,193,31,326,2021-03-04T00:00:00,3296,3296,1493,4789
ΑΙΤΩΛΟΑΚΑΡΝΑΝΙΑΣ,701,331,122,-3,453,2021-03-05T00:00:00,8775,8775,3666,12441
ΑΝΑΤΟΛΙΚΗΣ ΑΤΤΙΚΗΣ,901,854,147,52,1001,2021-03-05T00:00:00,17129,17129,9047,26176
ΑΝΔΡΟΥ,1201,0,0,0,0,2021-03-05T00:00:00,297,297,261,558
ΑΡΓΟΛΙΔΑΣ,1001,230,8,32,238,2021-03-05T00:00:00,5485,5485,2799,8284
ΑΡΚΑΔΙΑΣ,1002,199,19,30,218,2021-03-05T00:00:00,5437,5437,2732,8169
ΑΡΤΑΣ,401,134,21,14,155,2021-03-05T00:00:00,4410,4410,2909,7319
ΑΧΑΪΑΣ,702,553,29,-41,582,2021-03-05T00:00:00,15571,15571,9433,25004
ΒΟΙΩΤΙΑΣ,801,366,19,-11,385,2021-03-05T00:00:00,7614,7614,2610,10224
ΒΟΡΕΙΟΥ ΤΟΜΕΑ ΑΘΗΝΩΝ,902,3955,757,437,4712,2021-03-05T00:00:00,101112,101112,42440,143552
ΓΡΕΒΕΝΩΝ,301,90,30,6,120,2021-03-05T00:00:00,2208,2208,1135,3343
ΔΡΑΜΑΣ,101,199,45,-21,244,2021-03-05T00:00:00,5350,5350,3040,8390
ΔΥΤΙΚΗΣ ΑΤΤΙΚΗΣ,903,382,9,31,391,2021-03-05T00:00:00,6089,6089,2920,9009
ΔΥΤΙΚΟΥ ΤΟΜΕΑ ΑΘΗΝΩΝ,904,1148,364,106,1512,2021-03-05T00:00:00,25111,25111,16327,41438
ΕΒΡΟΥ,102,394,62,4,456,2021-03-05T00:00:00,9919,9919,5067,14986
ΕΥΒΟΙΑΣ,802,576,23,49,599,2021-03-05T00:00:00,11303,11303,5644,16947
ΕΥΡΥΤΑΝΙΑΣ,803,37,7,1,44,2021-03-05T00:00:00,1231,1231,650,1881
ΖΑΚΥΝΘΟΥ,601,60,5,-19,65,2021-03-05T00:00:00,1876,1876,1281,3157
ΗΛΕΙΑΣ,703,297,22,8,319,2021-03-05T00:00:00,6695,6695,3608,10303
ΗΜΑΘΙΑΣ,201,255,77,-39,332,2021-03-05T00:00:00,7705,7705,4029,11734
ΗΡΑΚΛΕΙΟΥ,1301,642,22,-5,664,2021-03-05T00:00:00,16871,16871,9025,25896
ΘΑΣΟΥ,103,1,10,11,11,2021-03-05T00:00:00,441,441,427,868
ΘΕΣΠΡΩΤΙΑΣ,402,219,7,-6,226,2021-03-05T00:00:00,3749,3749,2135,5884
ΘΕΣΣΑΛΟΝΙΚΗΣ,202,3046,672,-140,3718,2021-03-05T00:00:00,80700,80701,39622,120323
ΘΗΡΑΣ,1202,32,16,0,48,2021-03-05T00:00:00,570,570,347,917
ΙΘΑΚΗΣ,602,26,46,24,72,2021-03-05T00:00:00,436,436,49,485
ΙΚΑΡΙΑΣ,1101,39,5,0,44,2021-03-05T00:00:00,1218,1218,668,1886
ΙΩΑΝΝΙΝΩΝ,403,411,39,-12,450,2021-03-05T00:00:00,12464,12464,7451,19915
ΚΑΒΑΛΑΣ,104,230,63,-22,293,2021-03-05T00:00:00,6682,6682,4048,10730
ΚΑΛΥΜΝΟΥ,1203,96,9,87,105,2021-03-05T00:00:00,1205,1205,681,1886
ΚΑΡΔΙΤΣΑΣ,501,377,24,22,401,2021-03-05T00:00:00,8873,8873,3824,12697
ΚΑΡΠΑΘΟΥ,1204,25,5,6,30,2021-03-05T00:00:00,392,392,251,643
ΚΑΣΤΟΡΙΑΣ,302,191,19,6,210,2021-03-05T00:00:00,3631,3631,1937,5568
ΚΕΑΣ-ΚΥΘΝΟΥ,1205,2,10,6,12,2021-03-05T00:00:00,46,46,16,62
ΚΕΝΤΡΙΚΟΥ ΤΟΜΕΑ ΑΘΗΝΩΝ,905,3852,1274,401,5126,2021-03-05T00:00:00,96455,96455,58493,154948
ΚΕΡΚΥΡΑΣ,603,270,40,-13,310,2021-03-05T00:00:00,5225,5225,3057,8282
ΚΕΦΑΛΛΗΝΙΑΣ,604,162,5,27,167,2021-03-05T00:00:00,3026,3026,1620,4646
ΚΙΛΚΙΣ,203,295,60,-87,355,2021-03-05T00:00:00,5357,5357,2897,8254
ΚΟΖΑΝΗΣ,303,312,111,-24,423,2021-03-05T00:00:00,8163,8163,4205,12368
ΚΟΡΙΝΘΙΑΣ,1003,314,35,13,349,2021-03-05T00:00:00,6550,6550,2838,9388
ΚΩ,1206,150,4,-5,154,2021-03-05T00:00:00,2427,2427,919,3346
ΛΑΚΩΝΙΑΣ,1004,241,7,11,248,2021-03-05T00:00:00,5890,5890,2770,8660
ΛΑΡΙΣΑΣ,502,513,113,92,626,2021-03-05T00:00:00,14846,14846,7315,22161
ΛΑΣΙΘΙΟΥ,1302,266,20,10,286,2021-03-05T00:00:00,6276,6276,3901,10177
ΛΕΣΒΟΥ,1102,185,3,35,188,2021-03-05T00:00:00,4004,4004,2551,6555
ΛΕΥΚΑΔΑΣ,605,90,7,-8,97,2021-03-05T00:00:00,2684,2684,1361,4045
ΛΗΜΝΟΥ,1103,36,6,-6,42,2021-03-05T00:00:00,998,998,753,1751
ΜΑΓΝΗΣΙΑΣ,503,370,107,28,477,2021-03-05T00:00:00,8824,8824,4268,13092
ΜΕΣΣΗΝΙΑΣ,1005,293,52,29,345,2021-03-05T00:00:00,8565,8565,4830,13395
ΜΗΛΟΥ,1207,34,2,-6,36,2021-03-05T00:00:00,359,359,226,585
ΜΥΚΟΝΟΥ,1208,6,0,6,6,2021-03-05T00:00:00,176,176,143,319
ΝΑΞΟΥ,1209,33,3,-12,36,2021-03-05T00:00:00,651,651,427,1078
ΝΗΣΩΝ,906,121,14,15,135,2021-03-05T00:00:00,2508,2508,1660,4168
ΝΟΤΙΟΥ ΤΟΜΕΑ ΑΘΗΝΩΝ,907,782,249,100,1031,2021-03-05T00:00:00,16986,16986,7617,24603
ΞΑΝΘΗΣ,105,180,14,-37,194,2021-03-05T00:00:00,4428,4428,2289,6717
ΠΑΡΟΥ,1210,4,2,6,6,2021-03-05T00:00:00,308,308,292,600
ΠΕΙΡΑΙΩΣ,908,1267,160,70,1427,2021-03-05T00:00:00,26576,26576,14217,40793
ΠΕΛΛΑΣ,204,339,120,-3,459,2021-03-05T00:00:00,8637,8637,4956,13593
ΠΙΕΡΙΑΣ,205,193,82,-12,275,2021-03-05T00:00:00,5581,5581,3660,9241
ΠΡΕΒΕΖΑΣ,404,173,5,5,178,2021-03-05T00:00:00,3584,3584,1095,4679
ΡΕΘΥΜΝΟΥ,1303,267,10,-15,277,2021-03-05T00:00:00,5394,5394,2375,7769
ΡΟΔΟΠΗΣ,106,144,65,3,209,2021-03-05T00:00:00,4033,4033,1966,5999
ΡΟΔΟΥ,1211,195,79,28,274,2021-03-05T00:00:00,4974,4974,2456,7430
ΣΑΜΟΥ,1104,71,4,2,75,2021-03-05T00:00:00,1767,1767,875,2642
ΣΕΡΡΩΝ,206,309,85,5,394,2021-03-05T00:00:00,8603,8603,3148,11751
ΣΠΟΡΑΔΩΝ,504,0,0,-18,0,2021-03-05T00:00:00,351,351,237,588
ΣΥΡΟΥ,1212,34,2,-12,36,2021-03-05T00:00:00,1076,1076,851,1927
ΤΗΝΟΥ,1213,0,0,0,0,2021-03-05T00:00:00,314,314,279,593
ΤΡΙΚΑΛΩΝ,505,305,68,6,373,2021-03-05T00:00:00,8705,8705,4270,12975
ΦΘΙΩΤΙΔΑΣ,804,290,73,45,363,2021-03-05T00:00:00,6968,6968,3326,10294
ΦΛΩΡΙΝΑΣ,304,180,7,-22,187,2021-03-05T00:00:00,3316,3316,1632,4948
ΦΩΚΙΔΑΣ,805,67,1,-5,68,2021-03-05T00:00:00,2080,2080,961,3041
ΧΑΛΚΙΔΙΚΗΣ,207,344,32,-12,376,2021-03-05T00:00:00,6185,6185,2336,8521
ΧΑΝΙΩΝ,1304,470,51,10,521,2021-03-05T00:00:00,10964,10964,6600,17564
ΧΙΟΥ,1105,171,183,28,354,2021-03-05T00:00:00,3467,3467,1676,5143
ΑΙΤΩΛΟΑΚΑΡΝΑΝΙΑΣ,701,332,113,-8,445,2021-03-06T00:00:00,9107,9107,3779,12886
ΑΝΑΤΟΛΙΚΗΣ ΑΤΤΙΚΗΣ,901,847,121,-33,968,2021-03-06T00:00:00,17976,17976,9168,27144
ΑΝΔΡΟΥ,1201,0,0,0,0,2021-03-06T00:00:00,297,297,261,558
ΑΡΓΟΛΙΔΑΣ,1001,214,40,16,254,2021-03-06T00:00:00,5699,5699,2839,8538
ΑΡΚΑΔΙΑΣ,1002,209,14,5,223,2021-03-06T00:00:00,5646,5646,2746,8392
ΑΡΤΑΣ,401,149,10,4,159,2021-03-06T00:00:00,4559,4559,2919,7478
ΑΧΑΪΑΣ,702,672,39,129,711,2021-03-06T00:00:00,16243,16243,9472,25715
ΒΟΙΩΤΙΑΣ,801,355,33,3,388,2021-03-06T00:00:00,7969,7969,2643,10612
ΒΟΡΕΙΟΥ ΤΟΜΕΑ ΑΘΗΝΩΝ,902,3483,546,-683,4029,2021-03-06T00:00:00,104595,104595,42986,147581
ΓΡΕΒΕΝΩΝ,301,112,12,4,124,2021-03-06T00:00:00,2320,2320,1147,3467
ΔΡΑΜΑΣ,101,217,42,15,259,2021-03-06T00:00:00,5567,5567,3082,8649
ΔΥΤΙΚΗΣ ΑΤΤΙΚΗΣ,903,359,10,-22,369,2021-03-06T00:00:00,6448,6448,2930,9378
ΔΥΤΙΚΟΥ ΤΟΜΕΑ ΑΘΗΝΩΝ,904,1064,300,-148,1364,2021-03-06T00:00:00,26175,26175,16627,42802
ΕΒΡΟΥ,102,434,61,39,495,2021-03-06T00:00:00,10353,10353,5128,15481
ΕΥΒΟΙΑΣ,802,483,20,-96,503,2021-03-06T00:00:00,11786,11786,5664,17450
ΕΥΡΥΤΑΝΙΑΣ,803,55,2,13,57,2021-03-06T00:00:00,1286,1286,652,1938
ΖΑΚΥΝΘΟΥ,601,81,3,19,84,2021-03-06T00:00:00,1957,1957,1284,3241
ΗΛΕΙΑΣ,703,315,21,17,336,2021-03-06T00:00:00,7010,7010,3629,10639
ΗΜΑΘΙΑΣ,201,283,76,27,359,2021-03-06T00:00:00,7988,7988,4105,12093
ΗΡΑΚΛΕΙΟΥ,1301,627,37,0,664,2021-03-06T00:00:00,17498,17498,9062,26560
ΘΑΣΟΥ,103,0,0,-11,0,2021-03-06T00:00:00,441,441,427,868
ΘΕΣΠΡΩΤΙΑΣ,402,223,4,1,227,2021-03-06T00:00:00,3972,3972,2139,6111
ΘΕΣΣΑΛΟΝΙΚΗΣ,202,2933,632,-153,3565,2021-03-06T00:00:00,83633,83634,40254,123888
ΘΗΡΑΣ,1202,23,7,-18,30,2021-03-06T00:00:00,593,593,354,947
ΙΘΑΚΗΣ,602,28,26,-18,54,2021-03-06T00:00:00,464,464,75,539
ΙΚΑΡΙΑΣ,1101,45,1,2,46,2021-03-06T00:00:00,1263,1263,669,1932
ΙΩΑΝΝΙΝΩΝ,403,425,51,26,476,2021-03-06T00:00:00,12889,12889,7502,20391
ΚΑΒΑΛΑΣ,104,234,65,6,299,2021-03-06T00:00:00,6916,6916,4113,11029
ΚΑΛΥΜΝΟΥ,1203,70,2,-33,72,2021-03-06T00:00:00,1275,1275,683,1958
ΚΑΡΔΙΤΣΑΣ,501,381,18,-2,399,2021-03-06T00:00:00,9254,9254,3842,13096
ΚΑΡΠΑΘΟΥ,1204,12,0,-18,12,2021-03-06T00:00:00,404,404,251,655
ΚΑΣΤΟΡΙΑΣ,302,182,25,-3,207,2021-03-06T00:00:00,3813,3813,1962,5775
ΚΕΑΣ-ΚΥΘΝΟΥ,1205,0,0,-12,0,2021-03-06T00:00:00,46,46,16,62
ΚΕΝΤΡΙΚΟΥ ΤΟΜΕΑ ΑΘΗΝΩΝ,905,3273,1124,-729,4397,2021-03-06T00:00:00,99728,99728,59617,159345
ΚΕΡΚΥΡΑΣ,603,282,52,24,334,2021-03-06T00:00:00,5507,5507,3109,8616
ΚΕΦΑΛΛΗΝΙΑΣ,604,142,1,-24,143,2021-03-06T00:00:00,3168,3168,1621,4789
ΚΙΛΚΙΣ,203,285,33,-37,318,2021-03-06T00:00:00,5642,5642,2930,8572
ΚΟΖΑΝΗΣ,303,362,62,1,424,2021-03-06T00:00:00,8525,8525,4267,12792
ΚΟΡΙΝΘΙΑΣ,1003,309,41,1,350,2021-03-06T00:00:00,6859,6859,2879,9738
ΚΩ,1206,102,1,-51,103,2021-03-06T00:00:00,2529,2529,920,3449
ΛΑΚΩΝΙΑΣ,1004,239,19,10,258,2021-03-06T00:00:00,6129,6129,2789,8918
ΛΑΡΙΣΑΣ,502,424,126,-76,550,2021-03-06T00:00:00,15270,15270,7441,22711
ΛΑΣΙΘΙΟΥ,1302,305,20,39,325,2021-03-06T00:00:00,6581,6581,3921,10502
ΛΕΣΒΟΥ,1102,192,6,10,198,2021-03-06T00:00:00,4196,4196,2557,6753
ΛΕΥΚΑΔΑΣ,605,103,2,8,105,2021-03-06T00:00:00,2787,2787,1363,4150
ΛΗΜΝΟΥ,1103,46,8,12,54,2021-03-06T00:00:00,1044,1044,761,1805
ΜΑΓΝΗΣΙΑΣ,503,381,108,12,489,2021-03-06T00:00:00,9205,9205,4376,13581
ΜΕΣΣΗΝΙΑΣ,1005,289,49,-7,338,2021-03-06T00:00:00,8854,8854,4879,13733
ΜΗΛΟΥ,1207,0,0,-36,0,2021-03-06T00:00:00,359,359,226,585
ΜΥΚΟΝΟΥ,1208,0,0,-6,0,2021-03-06T00:00:00,176,176,143,319
ΝΑΞΟΥ,1209,40,2,6,42,2021-03-06T00:00:00,691,691,429,1120
ΝΗΣΩΝ,906,165,6,36,171,2021-03-06T00:00:00,2673,2673,1666,4339
ΝΟΤΙΟΥ ΤΟΜΕΑ ΑΘΗΝΩΝ,907,704,197,-130,901,2021-03-06T00:00:00,17690,17690,7814,25504
ΞΑΝΘΗΣ,105,199,16,21,215,2021-03-06T00:00:00,4627,4627,2305,6932
ΠΑΡΟΥ,1210,2,4,0,6,2021-03-06T00:00:00,310,310,296,606
ΠΕΙΡΑΙΩΣ,908,1219,110,-98,1329,2021-03-06T00:00:00,27795,27795,14327,42122
ΠΕΛΛΑΣ,204,358,93,-8,451,2021-03-06T00:00:00,8995,8995,5049,14044
ΠΙΕΡΙΑΣ,205,211,59,-5,270,2021-03-06T00:00:00,5792,5792,3719,9511
ΠΡΕΒΕΖΑΣ,404,173,6,1,179,2021-03-06T00:00:00,3757,3757,1101,4858
ΡΕΘΥΜΝΟΥ,1303,295,15,33,310,2021-03-06T00:00:00,5689,5689,2390,8079
ΡΟΔΟΠΗΣ,106,139,67,-3,206,2021-03-06T00:00:00,4172,4172,2033,6205
ΡΟΔΟΥ,1211,236,32,-6,268,2021-03-06T00:00:00,5210,5210,2488,7698
ΣΑΜΟΥ,1104,71,5,1,76,2021-03-06T00:00:00,1838,1838,880,2718
ΣΕΡΡΩΝ,206,323,81,10,404,2021-03-06T00:00:00,8926,8926,3229,12155
ΣΠΟΡΑΔΩΝ,504,2,4,6,6,2021-03-06T00:00:00,353,353,241,594
ΣΥΡΟΥ,1212,45,3,12,48,2021-03-06T00:00:00,1121,1121,854,1975
ΤΗΝΟΥ,1213,0,0,0,0,2021-03-06T00:00:00,314,314,279,593
ΤΡΙΚΑΛΩΝ,505,328,63,18,391,2021-03-06T00:00:00,9033,9033,4333,13366
ΦΘΙΩΤΙΔΑΣ,804,289,72,-2,361,2021-03-06T00:00:00,7257,7257,3398,10655
ΦΛΩΡΙΝΑΣ,304,166,11,-10,177,2021-03-06T00:00:00,3482,3482,1643,5125
ΦΩΚΙΔΑΣ,805,52,4,-12,56,2021-03-06T00:00:00,2132,2132,965,3097
ΧΑΛΚΙΔΙΚΗΣ,207,324,25,-27,349,2021-03-06T00:00:00,6509,6509,2361,8870
ΧΑΝΙΩΝ,1304,477,46,2,523,2021-03-06T00:00:00,11441,11441,6646,18087
ΧΙΟΥ,1105,113,29,-212,142,2021-03-06T00:00:00,3580,3580,1705,5285
ΑΙΤΩΛΟΑΚΑΡΝΑΝΙΑΣ,701,280,136,-29,416,2021-03-08T00:00:00,9387,9387,3915,13302
ΑΝΑΤΟΛΙΚΗΣ ΑΤΤΙΚΗΣ,901,842,112,-14,954,2021-03-08T00:00:00,18818,18818,9280,28098
ΑΝΔΡΟΥ,1201,0,0,0,0,2021-03-08T00:00:00,297,297,261,558
ΑΡΓΟΛΙΔΑΣ,1001,235,37,18,272,2021-03-08T00:00:00,5934,5934,2876,8810
ΑΡΚΑΔΙΑΣ,1002,253,16,46,269,2021-03-08T00:00:00,5899,5899,2762,8661
ΑΡΤΑΣ,401,133,36,10,169,2021-03-08T00:00:00,4692,4692,2955,7647
ΑΧΑΪΑΣ,702,629,127,45,756,2021-03-08T00:00:00,16872,16872,9599,26471
ΒΟΙΩΤΙΑΣ,801,394,22,28,416,2021-03-08T00:00:00,8363,8363,2665,11028
ΒΟΡΕΙΟΥ ΤΟΜΕΑ ΑΘΗΝΩΝ,902,3378,856,205,4234,2021-03-08T00:00:00,107973,107973,43842,151815
ΓΡΕΒΕΝΩΝ,301,102,10,-12,112,2021-03-08T00:00:00,2422,2422,1157,3579
ΔΡΑΜΑΣ,101,241,35,17,276,2021-03-08T00:00:00,5808,5808,3117,8925
ΔΥΤΙΚΗΣ ΑΤΤΙΚΗΣ,903,409,16,56,425,2021-03-08T00:00:00,6857,6857,2946,9803
ΔΥΤΙΚΟΥ ΤΟΜΕΑ ΑΘΗΝΩΝ,904,1206,211,53,1417,2021-03-08T00:00:00,27381,27381,16838,44219
ΕΒΡΟΥ,102,441,64,10,505,2021-03-08T00:00:00,10794,10794,5192,15986
ΕΥΒΟΙΑΣ,802,614,37,148,651,2021-03-08T00:00:00,12400,12400,5701,18101
ΕΥΡΥΤΑΝΙΑΣ,803,64,5,12,69,2021-03-08T00:00:00,1350,1350,657,2007
ΖΑΚΥΝΘΟΥ,601,91,4,11,95,2021-03-08T00:00:00,2048,2048,1288,3336
ΗΛΕΙΑΣ,703,375,21,60,396,2021-03-08T00:00:00,7385,7385,3650,11035
ΗΜΑΘΙΑΣ,201,267,98,6,365,2021-03-08T00:00:00,8255,8255,4203,12458
ΗΡΑΚΛΕΙΟΥ,1301,603,155,94,758,2021-03-08T00:00:00,18101,18101,9217,27318
ΘΑΣΟΥ,103,0,0,0,0,2021-03-08T00:00:00,441,441,427,868
ΘΕΣΠΡΩΤΙΑΣ,402,231,8,12,239,2021-03-08T00:00:00,4203,4203,2147,6350
ΘΕΣΣΑΛΟΝΙΚΗΣ,202,2592,753,-220,3345,2021-03-08T00:00:00,86225,86226,41007,127233
ΘΗΡΑΣ,1202,52,14,36,66,2021-03-08T00:00:00,645,645,368,1013
ΙΘΑΚΗΣ,602,39,3,-12,42,2021-03-08T00:00:00,503,503,78,581
ΙΚΑΡΙΑΣ,1101,47,0,1,47,2021-03-08T00:00:00,1310,1310,669,1979
ΙΩΑΝΝΙΝΩΝ,403,397,140,61,537,2021-03-08T00:00:00,13286,13286,7642,20928
ΚΑΒΑΛΑΣ,104,245,77,23,322,2021-03-08T00:00:00,7161,7161,4190,11351
ΚΑΛΥΜΝΟΥ,1203,75,7,10,82,2021-03-08T00:00:00,1350,1350,690,2040
ΚΑΡΔΙΤΣΑΣ,501,347,77,25,424,2021-03-08T00:00:00,9601,9601,3919,13520
ΚΑΡΠΑΘΟΥ,1204,18,0,6,18,2021-03-08T00:00:00,422,422,251,673
ΚΑΣΤΟΡΙΑΣ,302,193,9,-5,202,2021-03-08T00:00:00,4006,4006,1971,5977
ΚΕΑΣ-ΚΥΘΝΟΥ,1205,0,16,16,16,2021-03-08T00:00:00,46,46,32,78
ΚΕΝΤΡΙΚΟΥ ΤΟΜΕΑ ΑΘΗΝΩΝ,905,3355,1179,137,4534,2021-03-08T00:00:00,103083,103083,60796,163879
ΚΕΡΚΥΡΑΣ,603,280,50,-4,330,2021-03-08T00:00:00,5787,5787,3159,8946
ΚΕΦΑΛΛΗΝΙΑΣ,604,329,7,193,336,2021-03-08T00:00:00,3497,3497,1628,5125
ΚΙΛΚΙΣ,203,338,25,45,363,2021-03-08T00:00:00,5980,5980,2955,8935
ΚΟΖΑΝΗΣ,303,298,128,2,426,2021-03-08T00:00:00,8823,8823,4395,13218
ΚΟΡΙΝΘΙΑΣ,1003,281,68,-1,349,2021-03-08T00:00:00,7140,7140,2947,10087
ΚΩ,1206,101,4,2,105,2021-03-08T00:00:00,2630,2630,924,3554
ΛΑΚΩΝΙΑΣ,1004,276,22,40,298,2021-03-08T00:00:00,6405,6405,2811,9216
ΛΑΡΙΣΑΣ,502,413,199,62,612,2021-03-08T00:00:00,15683,15683,7640,23323
ΛΑΣΙΘΙΟΥ,1302,365,23,63,388,2021-03-08T00:00:00,6946,6946,3944,10890
ΛΕΣΒΟΥ,1102,197,4,3,201,2021-03-08T00:00:00,4393,4393,2561,6954
ΛΕΥΚΑΔΑΣ,605,96,7,-2,103,2021-03-08T00:00:00,2883,2883,1370,4253
ΛΗΜΝΟΥ,1103,51,3,0,54,2021-03-08T00:00:00,1095,1095,764,1859
ΜΑΓΝΗΣΙΑΣ,503,446,85,42,531,2021-03-08T00:00:00,9651,9651,4461,14112
ΜΕΣΣΗΝΙΑΣ,1005,332,32,26,364,2021-03-08T00:00:00,9186,9186,4911,14097
ΜΗΛΟΥ,1207,54,0,54,54,2021-03-08T00:00:00,413,413,226,639
ΜΥΚΟΝΟΥ,1208,0,0,0,0,2021-03-08T00:00:00,176,176,143,319
ΝΑΞΟΥ,1209,57,3,18,60,2021-03-08T00:00:00,748,748,432,1180
ΝΗΣΩΝ,906,156,5,-10,161,2021-03-08T00:00:00,2829,2829,1671,4500
ΝΟΤΙΟΥ ΤΟΜΕΑ ΑΘΗΝΩΝ,907,823,185,107,1008,2021-03-08T00:00:00,18513,18513,7999,26512
ΞΑΝΘΗΣ,105,214,20,19,234,2021-03-08T00:00:00,4841,4841,2325,7166
ΠΑΡΟΥ,1210,0,0,-6,0,2021-03-08T00:00:00,310,310,296,606
ΠΕΙΡΑΙΩΣ,908,1227,154,52,1381,2021-03-08T00:00:00,29022,29022,14481,43503
ΠΕΛΛΑΣ,204,352,110,11,462,2021-03-08T00:00:00,9347,9347,5159,14506
ΠΙΕΡΙΑΣ,205,184,103,17,287,2021-03-08T00:00:00,5976,5976,3822,9798
ΠΡΕΒΕΖΑΣ,404,182,10,13,192,2021-03-08T00:00:00,3939,3939,1111,5050
ΡΕΘΥΜΝΟΥ,1303,324,18,32,342,2021-03-08T00:00:00,6013,6013,2408,8421
ΡΟΔΟΠΗΣ,106,159,55,8,214,2021-03-08T00:00:00,4331,4331,2088,6419
ΡΟΔΟΥ,1211,194,38,-36,232,2021-03-08T00:00:00,5404,5404,2526,7930
ΣΑΜΟΥ,1104,88,6,18,94,2021-03-08T00:00:00,1926,1926,886,2812
ΣΕΡΡΩΝ,206,347,78,21,425,2021-03-08T00:00:00,9273,9273,3307,12580
ΣΠΟΡΑΔΩΝ,504,0,6,0,6,2021-03-08T00:00:00,353,353,247,600
ΣΥΡΟΥ,1212,47,1,0,48,2021-03-08T00:00:00,1168,1168,855,2023
ΤΗΝΟΥ,1213,0,0,0,0,2021-03-08T00:00:00,314,314,279,593
ΤΡΙΚΑΛΩΝ,505,251,140,0,391,2021-03-08T00:00:00,9284,9284,4473,13757
ΦΘΙΩΤΙΔΑΣ,804,324,72,35,396,2021-03-08T00:00:00,7581,7581,3470,11051
ΦΛΩΡΙΝΑΣ,304,201,12,36,213,2021-03-08T00:00:00,3683,3683,1655,5338
ΦΩΚΙΔΑΣ,805,77,5,26,82,2021-03-08T00:00:00,2209,2209,970,3179
ΧΑΛΚΙΔΙΚΗΣ,207,373,18,42,391,2021-03-08T00:00:00,6882,6882,2379,9261
ΧΑΝΙΩΝ,1304,546,55,78,601,2021-03-08T00:00:00,11987,11987,6701,18688
ΧΙΟΥ,1105,117,31,6,148,2021-03-08T00:00:00,3697,3697,1736,5433
ΑΙΤΩΛΟΑΚΑΡΝΑΝΙΑΣ,701,360,81,25,441,2021-03-09T00:00:00,9747,9747,3996,13743
ΑΝΑΤΟΛΙΚΗΣ ΑΤΤΙΚΗΣ,901,878,146,70,1024,2021-03-09T00:00:00,19696,19696,9426,29122
ΑΝΔΡΟΥ,1201,0,0,0,0,2021-03-09T00:00:00,297,297,261,558
ΑΡΓΟΛΙΔΑΣ,1001,209,35,-28,244,2021-03-09T00:00:00,6143,6143,2911,9054
ΑΡΚΑΔΙΑΣ,1002,206,17,-46,223,2021-03-09T00:00:00,6105,6105,2779,8884
ΑΡΤΑΣ,401,122,44,-3,166,2021-03-09T00:00:00,4814,4814,2999,7813
ΑΧΑΪΑΣ,702,588,121,-47,709,2021-03-09T00:00:00,17460,17460,9720,27180
ΒΟΙΩΤΙΑΣ,801,372,9,-35,381,2021-03-09T00:00:00,8735,8735,2674,11409
ΒΟΡΕΙΟΥ ΤΟΜΕΑ ΑΘΗΝΩΝ,902,3470,642,-122,4112,2021-03-09T00:00:00,111443,111443,44484,155927
ΓΡΕΒΕΝΩΝ,301,97,10,-5,107,2021-03-09T00:00:00,2519,2519,1167,3686
ΔΡΑΜΑΣ,101,204,31,-41,235,2021-03-09T00:00:00,6012,6012,3148,9160
ΔΥΤΙΚΗΣ ΑΤΤΙΚΗΣ,903,350,20,-55,370,2021-03-09T00:00:00,7207,7207,2966,10173
ΔΥΤΙΚΟΥ ΤΟΜΕΑ ΑΘΗΝΩΝ,904,1218,224,25,1442,2021-03-09T00:00:00,28599,28599,17062,45661
ΕΒΡΟΥ,102,374,73,-58,447,2021-03-09T00:00:00,11168,11168,5265,16433
ΕΥΒΟΙΑΣ,802,623,58,30,681,2021-03-09T00:00:00,13023,13023,5759,18782
ΕΥΡΥΤΑΝΙΑΣ,803,50,4,-15,54,2021-03-09T00:00:00,1400,1400,661,2061
ΖΑΚΥΝΘΟΥ,601,91,10,6,101,2021-03-09T00:00:00,2139,2139,1298,3437
ΗΛΕΙΑΣ,703,338,13,-45,351,2021-03-09T00:00:00,7723,7723,3663,11386
ΗΜΑΘΙΑΣ,201,251,113,-1,364,2021-03-09T00:00:00,8506,8506,4316,12822
ΗΡΑΚΛΕΙΟΥ,1301,564,142,-52,706,2021-03-09T00:00:00,18665,18665,9359,28024
ΘΑΣΟΥ,103,0,0,0,0,2021-03-09T00:00:00,441,441,427,868
ΘΕΣΠΡΩΤΙΑΣ,402,229,3,-7,232,2021-03-09T00:00:00,4432,4432,2150,6582
ΘΕΣΣΑΛΟΝΙΚΗΣ,202,2398,771,-176,3169,2021-03-09T00:00:00,88623,88624,41778,130402
ΘΗΡΑΣ,1202,65,1,0,66,2021-03-09T00:00:00,710,710,369,1079
ΙΘΑΚΗΣ,602,48,0,6,48,2021-03-09T00:00:00,551,551,78,629
ΙΚΑΡΙΑΣ,1101,39,0,-8,39,2021-03-09T00:00:00,1349,1349,669,2018
ΙΩΑΝΝΙΝΩΝ,403,328,162,-47,490,2021-03-09T00:00:00,13613,13614,7804,21418
ΚΑΒΑΛΑΣ,104,226,63,-33,289,2021-03-09T00:00:00,7387,7387,4253,11640
ΚΑΛΥΜΝΟΥ,1203,59,7,-16,66,2021-03-09T00:00:00,1409,1409,697,2106
ΚΑΡΔΙΤΣΑΣ,501,297,91,-36,388,2021-03-09T00:00:00,9898,9898,4010,13908
ΚΑΡΠΑΘΟΥ,1204,32,4,18,36,2021-03-09T00:00:00,454,454,255,709
ΚΑΣΤΟΡΙΑΣ,302,180,24,2,204,2021-03-09T00:00:00,4186,4186,1995,6181
ΚΕΑΣ-ΚΥΘΝΟΥ,1205,14,6,4,20,2021-03-09T00:00:00,60,60,38,98
ΚΕΝΤΡΙΚΟΥ ΤΟΜΕΑ ΑΘΗΝΩΝ,905,3538,893,-103,4431,2021-03-09T00:00:00,106621,106621,61689,168310
ΚΕΡΚΥΡΑΣ,603,275,72,17,347,2021-03-09T00:00:00,6062,6062,3231,9293
ΚΕΦΑΛΛΗΝΙΑΣ,604,168,0,-168,168,2021-03-09T00:00:00,3665,3665,1628,5293
ΚΙΛΚΙΣ,203,281,11,-71,292,2021-03-09T00:00:00,6261,6261,2966,9227
ΚΟΖΑΝΗΣ,303,313,116,3,429,2021-03-09T00:00:00,9136,9136,4511,13647
ΚΟΡΙΝΘΙΑΣ,1003,262,76,-11,338,2021-03-09T00:00:00,7402,7402,3023,10425
ΚΩ,1206,123,1,19,124,2021-03-09T00:00:00,2753,2753,925,3678
ΛΑΚΩΝΙΑΣ,1004,211,22,-65,233,2021-03-09T00:00:00,6616,6616,2833,9449
ΛΑΡΙΣΑΣ,502,312,180,-120,492,2021-03-09T00:00:00,15995,15995,7820,23815
ΛΑΣΙΘΙΟΥ,1302,266,36,-86,302,2021-03-09T00:00:00,7212,7212,3980,11192
ΛΕΣΒΟΥ,1102,199,3,1,202,2021-03-09T00:00:00,4592,4592,2564,7156
ΛΕΥΚΑΔΑΣ,605,73,4,-26,77,2021-03-09T00:00:00,2956,2956,1374,4330
ΛΗΜΝΟΥ,1103,49,5,0,54,2021-03-09T00:00:00,1144,1144,769,1913
ΜΑΓΝΗΣΙΑΣ,503,393,91,-47,484,2021-03-09T00:00:00,10044,10044,4552,14596
ΜΕΣΣΗΝΙΑΣ,1005,290,31,-43,321,2021-03-09T00:00:00,9476,9476,4942,14418
ΜΗΛΟΥ,1207,36,0,-18,36,2021-03-09T00:00:00,449,449,226,675
ΜΥΚΟΝΟΥ,1208,0,0,0,0,2021-03-09T00:00:00,176,176,143,319
ΝΑΞΟΥ,1209,29,1,-30,30,2021-03-09T00:00:00,777,777,433,1210
ΝΗΣΩΝ,906,167,6,12,173,2021-03-09T00:00:00,2996,2996,1677,4673
ΝΟΤΙΟΥ ΤΟΜΕΑ ΑΘΗΝΩΝ,907,717,110,-181,827,2021-03-09T00:00:00,19230,19230,8109,27339
ΞΑΝΘΗΣ,105,201,19,-14,220,2021-03-09T00:00:00,5042,5042,2344,7386
ΠΑΡΟΥ,1210,0,0,0,0,2021-03-09T00:00:00,310,310,296,606
ΠΕΙΡΑΙΩΣ,908,1262,112,-7,1374,2021-03-09T00:00:00,30284,30284,14593,44877
ΠΕΛΛΑΣ,204,349,106,-7,455,2021-03-09T00:00:00,9696,9696,5265,14961
ΠΙΕΡΙΑΣ,205,193,94,0,287,2021-03-09T00:00:00,6169,6169,3916,10085
ΠΡΕΒΕΖΑΣ,404,176,4,-12,180,2021-03-09T00:00:00,4115,4115,1115,5230
ΡΕΘΥΜΝΟΥ,1303,272,17,-53,289,2021-03-09T00:00:00,6285,6285,2425,8710
ΡΟΔΟΠΗΣ,106,164,51,1,215,2021-03-09T00:00:00,4495,4495,2139,6634
ΡΟΔΟΥ,1211,185,14,-33,199,2021-03-09T00:00:00,5589,5589,2540,8129
ΣΑΜΟΥ,1104,67,6,-21,73,2021-03-09T00:00:00,1993,1993,892,2885
ΣΕΡΡΩΝ,206,293,71,-61,364,2021-03-09T00:00:00,9566,9566,3378,12944
ΣΠΟΡΑΔΩΝ,504,18,0,12,18,2021-03-09T00:00:00,371,371,247,618
ΣΥΡΟΥ,1212,48,0,0,48,2021-03-09T00:00:00,1216,1216,855,2071
ΤΗΝΟΥ,1213,0,0,0,0,2021-03-09T00:00:00,314,314,279,593
ΤΡΙΚΑΛΩΝ,505,244,136,-11,380,2021-03-09T00:00:00,9528,9528,4609,14137
ΦΘΙΩΤΙΔΑΣ,804,310,69,-17,379,2021-03-09T00:00:00,7891,7891,3539,11430
ΦΛΩΡΙΝΑΣ,304,195,6,-12,201,2021-03-09T00:00:00,3878,3878,1661,5539
ΦΩΚΙΔΑΣ,805,70,11,-1,81,2021-03-09T00:00:00,2279,2279,981,3260
ΧΑΛΚΙΔΙΚΗΣ,207,310,29,-52,339,2021-03-09T00:00:00,7192,7192,2408,9600
ΧΑΝΙΩΝ,1304,446,53,-102,499,2021-03-09T00:00:00,12433,12433,6754,19187
ΧΙΟΥ,1105,116,44,12,160,2021-03-09T00:00:00,3813,3813,1780,5593
ΑΙΤΩΛΟΑΚΑΡΝΑΝΙΑΣ,701,330,73,-38,403,2021-03-10T00:00:00,10077,10077,4069,14146
ΑΝΑΤΟΛΙΚΗΣ ΑΤΤΙΚΗΣ,901,864,204,44,1068,2021-03-10T00:00:00,20560,20560,9630,30190
ΑΝΔΡΟΥ,1201,0,0,0,0,2021-03-10T00:00:00,297,297,261,558
ΑΡΓΟΛΙΔΑΣ,1001,222,21,-1,243,2021-03-10T00:00:00,6365,6365,2932,9297
ΑΡΚΑΔΙΑΣ,1002,211,12,0,223,2021-03-10T00:00:00,6316,6316,2791,9107
ΑΡΤΑΣ,401,96,72,2,168,2021-03-10T00:00:00,4910,4910,3071,7981
ΑΧΑΪΑΣ,702,656,80,27,736,2021-03-10T00:00:00,18116,18116,9800,27916
ΒΟΙΩΤΙΑΣ,801,379,17,15,396,2021-03-10T00:00:00,9114,9114,2691,11805
ΒΟΡΕΙΟΥ ΤΟΜΕΑ ΑΘΗΝΩΝ,902,3568,749,205,4317,2021-03-10T00:00:00,115011,115011,45233,160244
ΓΡΕΒΕΝΩΝ,301,91,18,2,109,2021-03-10T00:00:00,2610,2610,1185,3795
ΔΡΑΜΑΣ,101,243,15,23,258,2021-03-10T00:00:00,6255,6255,3163,9418
ΔΥΤΙΚΗΣ ΑΤΤΙΚΗΣ,903,276,3,-91,279,2021-03-10T00:00:00,7483,7483,2969,10452
ΔΥΤΙΚΟΥ ΤΟΜΕΑ ΑΘΗΝΩΝ,904,1215,170,-57,1385,2021-03-10T00:00:00,29814,29814,17232,47046
ΕΒΡΟΥ,102,385,64,2,449,2021-03-10T00:00:00,11553,11553,5329,16882
ΕΥΒΟΙΑΣ,802,506,52,-123,558,2021-03-10T00:00:00,13529,13529,5811,19340
ΕΥΡΥΤΑΝΙΑΣ,803,48,5,-1,53,2021-03-10T00:00:00,1448,1448,666,2114
ΖΑΚΥΝΘΟΥ,601,73,14,-14,87,2021-03-10T00:00:00,2212,2212,1312,3524
ΗΛΕΙΑΣ,703,340,22,11,362,2021-03-10T00:00:00,8063,8063,3685,11748
ΗΜΑΘΙΑΣ,201,248,125,9,373,2021-03-10T00:00:00,8754,8754,4441,13195
ΗΡΑΚΛΕΙΟΥ,1301,547,146,-13,693,2021-03-10T00:00:00,19212,19212,9505,28717
ΘΑΣΟΥ,103,0,0,0,0,2021-03-10T00:00:00,441,441,427,868
ΘΕΣΠΡΩΤΙΑΣ,402,205,5,-22,210,2021-03-10T00:00:00,4637,4637,2155,6792
ΘΕΣΣΑΛΟΝΙΚΗΣ,202,2385,614,-170,2999,2021-03-10T00:00:00,91008,91009,42392,133401
ΘΗΡΑΣ,1202,54,0,-12,54,2021-03-10T00:00:00,764,764,369,1133
ΙΘΑΚΗΣ,602,23,1,-24,24,2021-03-10T00:00:00,574,574,79,653
ΙΚΑΡΙΑΣ,1101,29,0,-10,29,2021-03-10T00:00:00,1378,1378,669,2047
ΙΩΑΝΝΙΝΩΝ,403,317,174,1,491,2021-03-10T00:00:00,13930,13931,7978,21909
ΚΑΒΑΛΑΣ,104,240,56,7,296,2021-03-10T00:00:00,7627,7627,4309,11936
ΚΑΛΥΜΝΟΥ,1203,30,0,-36,30,2021-03-10T00:00:00,1439,1439,697,2136
ΚΑΡΔΙΤΣΑΣ,501,287,91,-10,378,2021-03-10T00:00:00,10185,10185,4101,14286
ΚΑΡΠΑΘΟΥ,1204,18,0,-18,18,2021-03-10T00:00:00,472,472,255,727
ΚΑΣΤΟΡΙΑΣ,302,192,11,-1,203,2021-03-10T00:00:00,4378,4378,2006,6384
ΚΕΑΣ-ΚΥΘΝΟΥ,1205,18,0,-2,18,2021-03-10T00:00:00,78,78,38,116
ΚΕΝΤΡΙΚΟΥ ΤΟΜΕΑ ΑΘΗΝΩΝ,905,3654,1170,393,4824,2021-03-10T00:00:00,110275,110275,62859,173134
ΚΕΡΚΥΡΑΣ,603,287,30,-30,317,2021-03-10T00:00:00,6349,6349,3261,9610
ΚΕΦΑΛΛΗΝΙΑΣ,604,135,0,-33,135,2021-03-10T00:00:00,3800,3800,1628,5428
ΚΙΛΚΙΣ,203,276,9,-7,285,2021-03-10T00:00:00,6537,6537,2975,9512
ΚΟΖΑΝΗΣ,303,324,98,-7,422,2021-03-10T00:00:00,9460,9460,4609,14069
ΚΟΡΙΝΘΙΑΣ,1003,249,65,-24,314,2021-03-10T00:00:00,7651,7651,3088,10739
ΚΩ,1206,91,1,-32,92,2021-03-10T00:00:00,2844,2844,926,3770
ΛΑΚΩΝΙΑΣ,1004,193,34,-6,227,2021-03-10T00:00:00,6809,6809,2867,9676
ΛΑΡΙΣΑΣ,502,303,153,-36,456,2021-03-10T00:00:00,16298,16298,7973,24271
ΛΑΣΙΘΙΟΥ,1302,264,18,-20,282,2021-03-10T00:00:00,7476,7476,3998,11474
ΛΕΣΒΟΥ,1102,199,3,0,202,2021-03-10T00:00:00,4791,4791,2567,7358
ΛΕΥΚΑΔΑΣ,605,125,4,52,129,2021-03-10T00:00:00,3081,3081,1378,4459
ΛΗΜΝΟΥ,1103,41,7,-6,48,2021-03-10T00:00:00,1185,1185,776,1961
ΜΑΓΝΗΣΙΑΣ,503,420,59,-5,479,2021-03-10T00:00:00,10464,10464,4611,15075
ΜΕΣΣΗΝΙΑΣ,1005,283,53,15,336,2021-03-10T00:00:00,9759,9759,4995,14754
ΜΗΛΟΥ,1207,0,0,-36,0,2021-03-10T00:00:00,449,449,226,675
ΜΥΚΟΝΟΥ,1208,0,0,0,0,2021-03-10T00:00:00,176,176,143,319
ΝΑΞΟΥ,1209,35,1,6,36,2021-03-10T00:00:00,812,812,434,1246
ΝΗΣΩΝ,906,122,6,-45,128,2021-03-10T00:00:00,3118,3118,1683,4801
ΝΟΤΙΟΥ ΤΟΜΕΑ ΑΘΗΝΩΝ,907,775,181,129,956,2021-03-10T00:00:00,20005,20005,8290,28295
ΞΑΝΘΗΣ,105,187,21,-12,208,2021-03-10T00:00:00,5229,5229,2365,7594
ΠΑΡΟΥ,1210,0,0,0,0,2021-03-10T00:00:00,310,310,296,606
ΠΕΙΡΑΙΩΣ,908,1220,239,85,1459,2021-03-10T00:00:00,31504,31504,14832,46336
ΠΕΛΛΑΣ,204,380,89,14,469,2021-03-10T00:00:00,10076,10076,5354,15430
ΠΙΕΡΙΑΣ,205,212,83,8,295,2021-03-10T00:00:00,6381,6381,3999,10380
ΠΡΕΒΕΖΑΣ,404,161,9,-10,170,2021-03-10T00:00:00,4276,4276,1124,5400
ΡΕΘΥΜΝΟΥ,1303,268,22,1,290,2021-03-10T00:00:00,6553,6553,2447,9000
ΡΟΔΟΠΗΣ,106,158,55,-2,213,2021-03-10T00:00:00,4653,4653,2194,6847
ΡΟΔΟΥ,1211,170,21,-8,191,2021-03-10T00:00:00,5759,5759,2561,8320
ΣΑΜΟΥ,1104,66,2,-5,68,2021-03-10T00:00:00,2059,2059,894,2953
ΣΕΡΡΩΝ,206,286,59,-19,345,2021-03-10T00:00:00,9852,9852,3437,13289
ΣΠΟΡΑΔΩΝ,504,42,0,24,42,2021-03-10T00:00:00,413,413,247,660
ΣΥΡΟΥ,1212,40,2,-6,42,2021-03-10T00:00:00,1256,1256,857,2113
ΤΗΝΟΥ,1213,0,0,0,0,2021-03-10T00:00:00,314,314,279,593
ΤΡΙΚΑΛΩΝ,505,211,133,-36,344,2021-03-10T00:00:00,9739,9739,4742,14481
ΦΘΙΩΤΙΔΑΣ,804,307,62,-10,369,2021-03-10T00:00:00,8198,8198,3601,11799
ΦΛΩΡΙΝΑΣ,304,200,6,5,206,2021-03-10T00:00:00,4078,4078,1667,5745
ΦΩΚΙΔΑΣ,805,56,6,-19,62,2021-03-10T00:00:00,2335,2335,987,3322
ΧΑΛΚΙΔΙΚΗΣ,207,309,18,-12,327,2021-03-10T00:00:00,7501,7501,2426,9927
ΧΑΝΙΩΝ,1304,485,30,16,515,2021-03-10T00:00:00,12918,12918,6784,19702
ΧΙΟΥ,1105,114,30,-16,144,2021-03-10T00:00:00,3927,3927,1810,5737
ΑΙΤΩΛΟΑΚΑΡΝΑΝΙΑΣ,701,54,0,5,54,2021-01-14T00:00:00,793,793,0,793
ΑΝΑΤΟΛΙΚΗΣ ΑΤΤΙΚΗΣ,901,0,0,0,0,2021-01-14T00:00:00,707,707,0,707
ΑΝΔΡΟΥ,1201,0,0,0,0,2021-01-14T00:00:00,0,0,0,0
ΑΡΓΟΛΙΔΑΣ,1001,0,0,0,0,2021-01-14T00:00:00,260,260,0,260
ΑΡΚΑΔΙΑΣ,1002,0,0,-10,0,2021-01-14T00:00:00,495,495,0,495
ΑΡΤΑΣ,401,0,0,-30,0,2021-01-14T00:00:00,565,565,0,565
ΑΧΑΪΑΣ,702,60,0,-129,60,2021-01-14T00:00:00,2015,2015,0,2015
ΒΟΙΩΤΙΑΣ,801,0,0,0,0,2021-01-14T00:00:00,360,360,0,360
ΒΟΡΕΙΟΥ ΤΟΜΕΑ ΑΘΗΝΩΝ,902,1818,0,-650,1818,2021-01-14T00:00:00,9824,9824,0,9824
ΓΡΕΒΕΝΩΝ,301,0,0,0,0,2021-01-14T00:00:00,195,195,0,195
ΔΡΑΜΑΣ,101,0,0,0,0,2021-01-14T00:00:00,375,375,0,375
ΔΥΤΙΚΗΣ ΑΤΤΙΚΗΣ,903,19,0,-16,19,2021-01-14T00:00:00,526,526,0,526
ΔΥΤΙΚΟΥ ΤΟΜΕΑ ΑΘΗΝΩΝ,904,160,0,70,160,2021-01-14T00:00:00,2563,2563,0,2563
ΕΒΡΟΥ,102,130,0,-11,130,2021-01-14T00:00:00,965,965,0,965
ΕΥΒΟΙΑΣ,802,0,0,0,0,2021-01-14T00:00:00,575,575,0,575
ΕΥΡΥΤΑΝΙΑΣ,803,0,0,0,0,2021-01-14T00:00:00,145,145,0,145
ΖΑΚΥΝΘΟΥ,601,40,0,-10,40,2021-01-14T00:00:00,140,140,0,140
ΗΛΕΙΑΣ,703,0,0,0,0,2021-01-14T00:00:00,515,515,0,515
ΗΜΑΘΙΑΣ,201,25,0,-5,25,2021-01-14T00:00:00,629,629,0,629
ΗΡΑΚΛΕΙΟΥ,1301,225,0,11,225,2021-01-14T00:00:00,2047,2047,0,2047
ΘΑΣΟΥ,103,0,0,0,0,2021-01-14T00:00:00,0,0,0,0
ΘΕΣΠΡΩΤΙΑΣ,402,0,0,0,0,2021-01-14T00:00:00,225,225,0,225
ΘΕΣΣΑΛΟΝΙΚΗΣ,202,817,0,-392,817,2021-01-14T00:00:00,9340,9340,0,9340
ΘΗΡΑΣ,1202,0,0,0,0,2021-01-14T00:00:00,20,20,0,20
ΙΘΑΚΗΣ,602,0,0,0,0,2021-01-14T00:00:00,0,0,0,0
ΙΚΑΡΙΑΣ,1101,0,0,-5,0,2021-01-14T00:00:00,30,30,0,30
ΙΩΑΝΝΙΝΩΝ,403,121,0,21,121,2021-01-14T00:00:00,2324,2324,0,2324
ΚΑΒΑΛΑΣ,104,5,0,-50,5,2021-01-14T00:00:00,585,585,0,585
ΚΑΛΥΜΝΟΥ,1203,30,0,-58,30,2021-01-14T00:00:00,128,128,0,128
ΚΑΡΔΙΤΣΑΣ,501,0,0,0,0,2021-01-14T00:00:00,544,544,0,544
ΚΑΡΠΑΘΟΥ,1204,0,0,-5,0,2021-01-14T00:00:00,15,15,0,15
ΚΑΣΤΟΡΙΑΣ,302,0,0,-37,0,2021-01-14T00:00:00,276,276,0,276
ΚΕΑΣ-ΚΥΘΝΟΥ,1205,0,0,0,0,2021-01-14T00:00:00,0,0,0,0
ΚΕΝΤΡΙΚΟΥ ΤΟΜΕΑ ΑΘΗΝΩΝ,905,1311,0,-269,1311,2021-01-14T00:00:00,17384,17384,0,17384
ΚΕΡΚΥΡΑΣ,603,0,0,-35,0,2021-01-14T00:00:00,200,200,0,200
ΚΕΦΑΛΛΗΝΙΑΣ,604,0,0,-65,0,2021-01-14T00:00:00,175,175,0,175
ΚΙΛΚΙΣ,203,0,0,0,0,2021-01-14T00:00:00,305,305,0,305
ΚΟΖΑΝΗΣ,303,5,0,-35,5,2021-01-14T00:00:00,678,678,0,678
ΚΟΡΙΝΘΙΑΣ,1003,0,0,-10,0,2021-01-14T00:00:00,300,300,0,300
ΚΩ,1206,45,0,0,45,2021-01-14T00:00:00,90,90,0,90
ΛΑΚΩΝΙΑΣ,1004,0,0,0,0,2021-01-14T00:00:00,399,399,0,399
ΛΑΡΙΣΑΣ,502,4,0,-26,4,2021-01-14T00:00:00,1715,1715,0,1715
ΛΑΣΙΘΙΟΥ,1302,0,0,-41,0,2021-01-14T00:00:00,509,509,0,509
ΛΕΣΒΟΥ,1102,60,0,-25,60,2021-01-14T00:00:00,215,215,0,215
ΛΕΥΚΑΔΑΣ,605,5,0,-10,5,2021-01-14T00:00:00,100,100,0,100
ΛΗΜΝΟΥ,1103,56,0,-8,56,2021-01-14T00:00:00,163,163,0,163
ΜΑΓΝΗΣΙΑΣ,503,45,0,-14,45,2021-01-14T00:00:00,628,628,0,628
ΜΕΣΣΗΝΙΑΣ,1005,5,0,5,5,2021-01-14T00:00:00,565,565,0,565
ΜΗΛΟΥ,1207,0,0,0,0,2021-01-14T00:00:00,0,0,0,0
ΜΥΚΟΝΟΥ,1208,0,0,0,0,2021-01-14T00:00:00,0,0,0,0
ΝΑΞΟΥ,1209,10,0,10,10,2021-01-14T00:00:00,45,45,0,45
ΝΗΣΩΝ,906,0,0,0,0,2021-01-14T00:00:00,25,25,0,25
ΝΟΤΙΟΥ ΤΟΜΕΑ ΑΘΗΝΩΝ,907,361,0,-70,361,2021-01-14T00:00:00,906,906,0,906
ΞΑΝΘΗΣ,105,5,0,-10,5,2021-01-14T00:00:00,505,505,0,505
ΠΑΡΟΥ,1210,0,0,0,0,2021-01-14T00:00:00,0,0,0,0
ΠΕΙΡΑΙΩΣ,908,274,0,-328,274,2021-01-14T00:00:00,2706,2706,0,2706
ΠΕΛΛΑΣ,204,0,0,0,0,2021-01-14T00:00:00,525,525,0,525
ΠΙΕΡΙΑΣ,205,10,0,0,10,2021-01-14T00:00:00,393,393,0,393
ΠΡΕΒΕΖΑΣ,404,0,0,0,0,2021-01-14T00:00:00,320,320,0,320
ΡΕΘΥΜΝΟΥ,1303,40,0,-25,40,2021-01-14T00:00:00,405,405,0,405
ΡΟΔΟΠΗΣ,106,0,0,-35,0,2021-01-14T00:00:00,295,295,0,295
ΡΟΔΟΥ,1211,115,0,0,115,2021-01-14T00:00:00,340,340,0,340
ΣΑΜΟΥ,1104,45,0,-5,45,2021-01-14T00:00:00,155,155,0,155
ΣΕΡΡΩΝ,206,10,0,-80,10,2021-01-14T00:00:00,610,610,0,610
ΣΠΟΡΑΔΩΝ,504,0,0,0,0,2021-01-14T00:00:00,0,0,0,0
ΣΥΡΟΥ,1212,50,0,0,50,2021-01-14T00:00:00,150,150,0,150
ΤΗΝΟΥ,1213,0,0,0,0,2021-01-14T00:00:00,0,0,0,0
ΤΡΙΚΑΛΩΝ,505,0,0,-15,0,2021-01-14T00:00:00,635,635,0,635
ΦΘΙΩΤΙΔΑΣ,804,23,0,-17,23,2021-01-14T00:00:00,638,638,0,638
ΦΛΩΡΙΝΑΣ,304,0,0,0,0,2021-01-14T00:00:00,241,241,0,241
ΦΩΚΙΔΑΣ,805,0,0,0,0,2021-01-14T00:00:00,105,105,0,105
ΧΑΛΚΙΔΙΚΗΣ,207,0,0,0,0,2021-01-14T00:00:00,245,245,0,245
ΧΑΝΙΩΝ,1304,0,0,0,0,2021-01-14T00:00:00,929,929,0,929
ΧΙΟΥ,1105,45,0,-20,45,2021-01-14T00:00:00,180,180,0,180
ΑΙΤΩΛΟΑΚΑΡΝΑΝΙΑΣ,701,26,0,-28,26,2021-01-15T00:00:00,819,819,0,819
ΑΝΑΤΟΛΙΚΗΣ ΑΤΤΙΚΗΣ,901,0,0,0,0,2021-01-15T00:00:00,707,707,0,707
ΑΝΔΡΟΥ,1201,0,0,0,0,2021-01-15T00:00:00,0,0,0,0
ΑΡΓΟΛΙΔΑΣ,1001,0,0,0,0,2021-01-15T00:00:00,260,260,0,260
ΑΡΚΑΔΙΑΣ,1002,0,0,0,0,2021-01-15T00:00:00,495,495,0,495
ΑΡΤΑΣ,401,0,0,0,0,2021-01-15T00:00:00,565,565,0,565
ΑΧΑΪΑΣ,702,65,0,5,65,2021-01-15T00:00:00,2080,2080,0,2080
ΒΟΙΩΤΙΑΣ,801,0,0,0,0,2021-01-15T00:00:00,360,360,0,360
ΒΟΡΕΙΟΥ ΤΟΜΕΑ ΑΘΗΝΩΝ,902,1841,0,23,1841,2021-01-15T00:00:00,11665,11665,0,11665
ΓΡΕΒΕΝΩΝ,301,0,0,0,0,2021-01-15T00:00:00,195,195,0,195
ΔΡΑΜΑΣ,101,0,0,0,0,2021-01-15T00:00:00,375,375,0,375
ΔΥΤΙΚΗΣ ΑΤΤΙΚΗΣ,903,24,0,5,24,2021-01-15T00:00:00,550,550,0,550
ΔΥΤΙΚΟΥ ΤΟΜΕΑ ΑΘΗΝΩΝ,904,120,0,-40,120,2021-01-15T00:00:00,2683,2683,0,2683
ΕΒΡΟΥ,102,124,0,-6,124,2021-01-15T00:00:00,1089,1089,0,1089
ΕΥΒΟΙΑΣ,802,0,0,0,0,2021-01-15T00:00:00,575,575,0,575
ΕΥΡΥΤΑΝΙΑΣ,803,0,0,0,0,2021-01-15T00:00:00,145,145,0,145
ΖΑΚΥΝΘΟΥ,601,0,0,-40,0,2021-01-15T00:00:00,140,140,0,140
ΗΛΕΙΑΣ,703,0,0,0,0,2021-01-15T00:00:00,515,515,0,515
ΗΜΑΘΙΑΣ,201,0,0,-25,0,2021-01-15T00:00:00,629,629,0,629
ΗΡΑΚΛΕΙΟΥ,1301,233,0,8,233,2021-01-15T00:00:00,2280,2280,0,2280
ΘΑΣΟΥ,103,0,0,0,0,2021-01-15T00:00:00,0,0,0,0
ΘΕΣΠΡΩΤΙΑΣ,402,0,0,0,0,2021-01-15T00:00:00,225,225,0,225
ΘΕΣΣΑΛΟΝΙΚΗΣ,202,760,0,-57,760,2021-01-15T00:00:00,10100,10100,0,10100
ΘΗΡΑΣ,1202,0,0,0,0,2021-01-15T00:00:00,20,20,0,20
ΙΘΑΚΗΣ,602,0,0,0,0,2021-01-15T00:00:00,0,0,0,0
ΙΚΑΡΙΑΣ,1101,0,0,0,0,2021-01-15T00:00:00,30,30,0,30
ΙΩΑΝΝΙΝΩΝ,403,104,0,-17,104,2021-01-15T00:00:00,2428,2428,0,2428
ΚΑΒΑΛΑΣ,104,0,0,-5,0,2021-01-15T00:00:00,585,585,0,585
ΚΑΛΥΜΝΟΥ,1203,0,0,-30,0,2021-01-15T00:00:00,128,128,0,128
ΚΑΡΔΙΤΣΑΣ,501,0,0,0,0,2021-01-15T00:00:00,544,544,0,544
ΚΑΡΠΑΘΟΥ,1204,0,0,0,0,2021-01-15T00:00:00,15,15,0,15
ΚΑΣΤΟΡΙΑΣ,302,0,0,0,0,2021-01-15T00:00:00,276,276,0,276
ΚΕΑΣ-ΚΥΘΝΟΥ,1205,0,0,0,0,2021-01-15T00:00:00,0,0,0,0
ΚΕΝΤΡΙΚΟΥ ΤΟΜΕΑ ΑΘΗΝΩΝ,905,549,0,-762,549,2021-01-15T00:00:00,17933,17933,0,17933
ΚΕΡΚΥΡΑΣ,603,0,0,0,0,2021-01-15T00:00:00,200,200,0,200
ΚΕΦΑΛΛΗΝΙΑΣ,604,0,0,0,0,2021-01-15T00:00:00,175,175,0,175
ΚΙΛΚΙΣ,203,0,0,0,0,2021-01-15T00:00:00,305,305,0,305
ΚΟΖΑΝΗΣ,303,25,0,20,25,2021-01-15T00:00:00,703,703,0,703
ΚΟΡΙΝΘΙΑΣ,1003,0,0,0,0,2021-01-15T00:00:00,300,300,0,300
ΚΩ,1206,0,0,-45,0,2021-01-15T00:00:00,90,90,0,90
ΛΑΚΩΝΙΑΣ,1004,0,0,0,0,2021-01-15T00:00:00,399,399,0,399
ΛΑΡΙΣΑΣ,502,11,0,7,11,2021-01-15T00:00:00,1726,1726,0,1726
ΛΑΣΙΘΙΟΥ,1302,10,0,10,10,2021-01-15T00:00:00,519,519,0,519
ΛΕΣΒΟΥ,1102,0,0,-60,0,2021-01-15T00:00:00,215,215,0,215
ΛΕΥΚΑΔΑΣ,605,0,0,-5,0,2021-01-15T00:00:00,100,100,0,100
ΛΗΜΝΟΥ,1103,0,0,-56,0,2021-01-15T00:00:00,163,163,0,163
ΜΑΓΝΗΣΙΑΣ,503,5,0,-40,5,2021-01-15T00:00:00,633,633,0,633
ΜΕΣΣΗΝΙΑΣ,1005,0,0,-5,0,2021-01-15T00:00:00,565,565,0,565
ΜΗΛΟΥ,1207,0,0,0,0,2021-01-15T00:00:00,0,0,0,0
ΜΥΚΟΝΟΥ,1208,0,0,0,0,2021-01-15T00:00:00,0,0,0,0
ΝΑΞΟΥ,1209,0,0,-10,0,2021-01-15T00:00:00,45,45,0,45
ΝΗΣΩΝ,906,0,0,0,0,2021-01-15T00:00:00,25,25,0,25
ΝΟΤΙΟΥ ΤΟΜΕΑ ΑΘΗΝΩΝ,907,234,0,-127,234,2021-01-15T00:00:00,1140,1140,0,1140
ΞΑΝΘΗΣ,105,5,0,0,5,2021-01-15T00:00:00,510,510,0,510
ΠΑΡΟΥ,1210,0,0,0,0,2021-01-15T00:00:00,0,0,0,0
ΠΕΙΡΑΙΩΣ,908,0,0,-274,0,2021-01-15T00:00:00,2706,2706,0,2706
ΠΕΛΛΑΣ,204,0,0,0,0,2021-01-15T00:00:00,525,525,0,525
ΠΙΕΡΙΑΣ,205,10,0,0,10,2021-01-15T00:00:00,403,403,0,403
ΠΡΕΒΕΖΑΣ,404,0,0,0,0,2021-01-15T00:00:00,320,320,0,320
ΡΕΘΥΜΝΟΥ,1303,50,0,10,50,2021-01-15T00:00:00,455,455,0,455
ΡΟΔΟΠΗΣ,106,0,0,0,0,2021-01-15T00:00:00,295,295,0,295
ΡΟΔΟΥ,1211,95,0,-20,95,2021-01-15T00:00:00,435,435,0,435
ΣΑΜΟΥ,1104,35,0,-10,35,2021-01-15T00:00:00,190,190,0,190
ΣΕΡΡΩΝ,206,0,0,-10,0,2021-01-15T00:00:00,610,610,0,610
ΣΠΟΡΑΔΩΝ,504,0,0,0,0,2021-01-15T00:00:00,0,0,0,0
ΣΥΡΟΥ,1212,20,0,-30,20,2021-01-15T00:00:00,170,170,0,170
ΤΗΝΟΥ,1213,0,0,0,0,2021-01-15T00:00:00,0,0,0,0
ΤΡΙΚΑΛΩΝ,505,0,0,0,0,2021-01-15T00:00:00,635,635,0,635
ΦΘΙΩΤΙΔΑΣ,804,46,0,23,46,2021-01-15T00:00:00,684,684,0,684
ΦΛΩΡΙΝΑΣ,304,0,0,0,0,2021-01-15T00:00:00,241,241,0,241
ΦΩΚΙΔΑΣ,805,0,0,0,0,2021-01-15T00:00:00,105,105,0,105
ΧΑΛΚΙΔΙΚΗΣ,207,0,0,0,0,2021-01-15T00:00:00,245,245,0,245
ΧΑΝΙΩΝ,1304,0,0,0,0,2021-01-15T00:00:00,929,929,0,929
ΧΙΟΥ,1105,60,0,15,60,2021-01-15T00:00:00,240,240,0,240
ΑΙΤΩΛΟΑΚΑΡΝΑΝΙΑΣ,701,30,0,4,30,2021-01-16T00:00:00,849,849,0,849
ΑΝΑΤΟΛΙΚΗΣ ΑΤΤΙΚΗΣ,901,20,0,20,20,2021-01-16T00:00:00,727,727,0,727
ΑΝΔΡΟΥ,1201,0,0,0,0,2021-01-16T00:00:00,0,0,0,0
ΑΡΓΟΛΙΔΑΣ,1001,65,0,65,65,2021-01-16T00:00:00,325,325,0,325
ΑΡΚΑΔΙΑΣ,1002,30,0,30,30,2021-01-16T00:00:00,525,525,0,525
ΑΡΤΑΣ,401,25,0,25,25,2021-01-16T00:00:00,590,590,0,590
ΑΧΑΪΑΣ,702,120,0,55,120,2021-01-16T00:00:00,2200,2200,0,2200
ΒΟΙΩΤΙΑΣ,801,15,0,15,15,2021-01-16T00:00:00,375,375,0,375
ΒΟΡΕΙΟΥ ΤΟΜΕΑ ΑΘΗΝΩΝ,902,683,0,-1158,683,2021-01-16T00:00:00,12348,12348,0,12348
ΓΡΕΒΕΝΩΝ,301,20,0,20,20,2021-01-16T00:00:00,215,215,0,215
ΔΡΑΜΑΣ,101,50,0,50,50,2021-01-16T00:00:00,425,425,0,425
ΔΥΤΙΚΗΣ ΑΤΤΙΚΗΣ,903,15,0,-9,15,2021-01-16T00:00:00,565,565,0,565
ΔΥΤΙΚΟΥ ΤΟΜΕΑ ΑΘΗΝΩΝ,904,124,0,4,124,2021-01-16T00:00:00,2807,2807,0,2807
ΕΒΡΟΥ,102,106,0,-18,106,2021-01-16T00:00:00,1195,1195,0,1195
ΕΥΒΟΙΑΣ,802,48,0,48,48,2021-01-16T00:00:00,623,623,0,623
ΕΥΡΥΤΑΝΙΑΣ,803,15,0,15,15,2021-01-16T00:00:00,160,160,0,160
ΖΑΚΥΝΘΟΥ,601,30,0,30,30,2021-01-16T00:00:00,170,170,0,170
ΗΛΕΙΑΣ,703,52,0,52,52,2021-01-16T00:00:00,567,567,0,567
ΗΜΑΘΙΑΣ,201,29,0,29,29,2021-01-16T00:00:00,658,658,0,658
ΗΡΑΚΛΕΙΟΥ,1301,307,0,74,307,2021-01-16T00:00:00,2587,2587,0,2587
ΘΑΣΟΥ,103,0,0,0,0,2021-01-16T00:00:00,0,0,0,0
ΘΕΣΠΡΩΤΙΑΣ,402,50,0,50,50,2021-01-16T00:00:00,275,275,0,275
ΘΕΣΣΑΛΟΝΙΚΗΣ,202,610,0,-150,610,2021-01-16T00:00:00,10710,10710,0,10710
ΘΗΡΑΣ,1202,10,0,10,10,2021-01-16T00:00:00,30,30,0,30
ΙΘΑΚΗΣ,602,0,0,0,0,2021-01-16T00:00:00,0,0,0,0
ΙΚΑΡΙΑΣ,1101,5,0,5,5,2021-01-16T00:00:00,35,35,0,35
ΙΩΑΝΝΙΝΩΝ,403,136,0,32,136,2021-01-16T00:00:00,2564,2564,0,2564
ΚΑΒΑΛΑΣ,104,55,0,55,55,2021-01-16T00:00:00,640,640,0,640
ΚΑΛΥΜΝΟΥ,1203,5,0,5,5,2021-01-16T00:00:00,133,133,0,133
ΚΑΡΔΙΤΣΑΣ,501,45,0,45,45,2021-01-16T00:00:00,589,589,0,589
ΚΑΡΠΑΘΟΥ,1204,0,0,0,0,2021-01-16T00:00:00,15,15,0,15
ΚΑΣΤΟΡΙΑΣ,302,21,0,21,21,2021-01-16T00:00:00,297,297,0,297
ΚΕΑΣ-ΚΥΘΝΟΥ,1205,0,0,0,0,2021-01-16T00:00:00,0,0,0,0
ΚΕΝΤΡΙΚΟΥ ΤΟΜΕΑ ΑΘΗΝΩΝ,905,1032,2,485,1034,2021-01-16T00:00:00,18965,18965,2,18967
ΚΕΡΚΥΡΑΣ,603,55,0,55,55,2021-01-16T00:00:00,255,255,0,255
ΚΕΦΑΛΛΗΝΙΑΣ,604,45,0,45,45,2021-01-16T00:00:00,220,220,0,220
ΚΙΛΚΙΣ,203,35,0,35,35,2021-01-16T00:00:00,340,340,0,340
ΚΟΖΑΝΗΣ,303,37,0,12,37,2021-01-16T00:00:00,740,740,0,740
ΚΟΡΙΝΘΙΑΣ,1003,20,0,20,20,2021-01-16T00:00:00,320,320,0,320
ΚΩ,1206,17,0,17,17,2021-01-16T00:00:00,107,107,0,107
ΛΑΚΩΝΙΑΣ,1004,30,0,30,30,2021-01-16T00:00:00,429,429,0,429
ΛΑΡΙΣΑΣ,502,120,0,109,120,2021-01-16T00:00:00,1846,1846,0,1846
ΛΑΣΙΘΙΟΥ,1302,40,0,30,40,2021-01-16T00:00:00,559,559,0,559
ΛΕΣΒΟΥ,1102,35,0,35,35,2021-01-16T00:00:00,250,250,0,250
ΛΕΥΚΑΔΑΣ,605,15,0,15,15,2021-01-16T00:00:00,115,115,0,115
ΛΗΜΝΟΥ,1103,5,0,5,5,2021-01-16T00:00:00,168,168,0,168
ΜΑΓΝΗΣΙΑΣ,503,0,0,-5,0,2021-01-16T00:00:00,633,633,0,633
ΜΕΣΣΗΝΙΑΣ,1005,45,0,45,45,2021-01-16T00:00:00,610,610,0,610
ΜΗΛΟΥ,1207,0,0,0,0,2021-01-16T00:00:00,0,0,0,0
ΜΥΚΟΝΟΥ,1208,0,0,0,0,2021-01-16T00:00:00,0,0,0,0
ΝΑΞΟΥ,1209,5,0,5,5,2021-01-16T00:00:00,50,50,0,50
ΝΗΣΩΝ,906,15,0,15,15,2021-01-16T00:00:00,40,40,0,40
ΝΟΤΙΟΥ ΤΟΜΕΑ ΑΘΗΝΩΝ,907,135,0,-99,135,2021-01-16T00:00:00,1275,1275,0,1275
ΞΑΝΘΗΣ,105,45,0,40,45,2021-01-16T00:00:00,555,555,0,555
ΠΑΡΟΥ,1210,0,0,0,0,2021-01-16T00:00:00,0,0,0,0
ΠΕΙΡΑΙΩΣ,908,145,0,145,145,2021-01-16T00:00:00,2851,2851,0,2851
ΠΕΛΛΑΣ,204,28,0,28,28,2021-01-16T00:00:00,553,553,0,553
ΠΙΕΡΙΑΣ,205,30,0,20,30,2021-01-16T00:00:00,433,433,0,433
ΠΡΕΒΕΖΑΣ,404,19,0,19,19,2021-01-16T00:00:00,339,339,0,339
ΡΕΘΥΜΝΟΥ,1303,15,0,-35,15,2021-01-16T00:00:00,470,470,0,470
ΡΟΔΟΠΗΣ,106,25,0,25,25,2021-01-16T00:00:00,320,320,0,320
ΡΟΔΟΥ,1211,0,0,-95,0,2021-01-16T00:00:00,435,435,0,435
ΣΑΜΟΥ,1104,10,0,-25,10,2021-01-16T00:00:00,200,200,0,200
ΣΕΡΡΩΝ,206,40,0,40,40,2021-01-16T00:00:00,650,650,0,650
ΣΠΟΡΑΔΩΝ,504,0,0,0,0,2021-01-16T00:00:00,0,0,0,0
ΣΥΡΟΥ,1212,0,0,-20,0,2021-01-16T00:00:00,170,170,0,170
ΤΗΝΟΥ,1213,0,0,0,0,2021-01-16T00:00:00,0,0,0,0
ΤΡΙΚΑΛΩΝ,505,45,0,45,45,2021-01-16T00:00:00,680,680,0,680
ΦΘΙΩΤΙΔΑΣ,804,36,0,-10,36,2021-01-16T00:00:00,720,720,0,720
ΦΛΩΡΙΝΑΣ,304,23,0,23,23,2021-01-16T00:00:00,264,264,0,264
ΦΩΚΙΔΑΣ,805,15,0,15,15,2021-01-16T00:00:00,120,120,0,120
ΧΑΛΚΙΔΙΚΗΣ,207,20,0,20,20,2021-01-16T00:00:00,265,265,0,265
ΧΑΝΙΩΝ,1304,54,0,54,54,2021-01-16T00:00:00,983,983,0,983
ΧΙΟΥ,1105,20,0,-40,20,2021-01-16T00:00:00,260,260,0,260
ΑΙΤΩΛΟΑΚΑΡΝΑΝΙΑΣ,701,40,0,10,40,2021-01-18T00:00:00,889,889,0,889
ΑΝΑΤΟΛΙΚΗΣ ΑΤΤΙΚΗΣ,901,40,57,77,97,2021-01-18T00:00:00,767,767,57,824
ΑΝΔΡΟΥ,1201,0,0,0,0,2021-01-18T00:00:00,0,0,0,0
ΑΡΓΟΛΙΔΑΣ,1001,51,0,-14,51,2021-01-18T00:00:00,376,376,0,376
ΑΡΚΑΔΙΑΣ,1002,40,0,10,40,2021-01-18T00:00:00,565,565,0,565
ΑΡΤΑΣ,401,26,0,1,26,2021-01-18T00:00:00,616,616,0,616
ΑΧΑΪΑΣ,702,193,0,73,193,2021-01-18T00:00:00,2393,2393,0,2393
ΒΟΙΩΤΙΑΣ,801,36,0,21,36,2021-01-18T00:00:00,411,411,0,411
ΒΟΡΕΙΟΥ ΤΟΜΕΑ ΑΘΗΝΩΝ,902,687,0,4,687,2021-01-18T00:00:00,13035,13035,0,13035
ΓΡΕΒΕΝΩΝ,301,30,0,10,30,2021-01-18T00:00:00,245,245,0,245
ΔΡΑΜΑΣ,101,38,0,-12,38,2021-01-18T00:00:00,463,463,0,463
ΔΥΤΙΚΗΣ ΑΤΤΙΚΗΣ,903,15,85,85,100,2021-01-18T00:00:00,580,580,85,665
ΔΥΤΙΚΟΥ ΤΟΜΕΑ ΑΘΗΝΩΝ,904,64,103,43,167,2021-01-18T00:00:00,2871,2871,103,2974
ΕΒΡΟΥ,102,113,0,7,113,2021-01-18T00:00:00,1308,1308,0,1308
ΕΥΒΟΙΑΣ,802,103,0,55,103,2021-01-18T00:00:00,726,726,0,726
ΕΥΡΥΤΑΝΙΑΣ,803,15,0,0,15,2021-01-18T00:00:00,175,175,0,175
ΖΑΚΥΝΘΟΥ,601,20,0,-10,20,2021-01-18T00:00:00,190,190,0,190
ΗΛΕΙΑΣ,703,70,0,18,70,2021-01-18T00:00:00,637,637,0,637
ΗΜΑΘΙΑΣ,201,50,0,21,50,2021-01-18T00:00:00,708,708,0,708
ΗΡΑΚΛΕΙΟΥ,1301,449,0,142,449,2021-01-18T00:00:00,3036,3036,0,3036
ΘΑΣΟΥ,103,0,0,0,0,2021-01-18T00:00:00,0,0,0,0
ΘΕΣΠΡΩΤΙΑΣ,402,31,0,-19,31,2021-01-18T00:00:00,306,306,0,306
ΘΕΣΣΑΛΟΝΙΚΗΣ,202,638,0,28,638,2021-01-18T00:00:00,11348,11348,0,11348
ΘΗΡΑΣ,1202,5,0,-5,5,2021-01-18T00:00:00,35,35,0,35
ΙΘΑΚΗΣ,602,0,0,0,0,2021-01-18T00:00:00,0,0,0,0
ΙΚΑΡΙΑΣ,1101,5,0,0,5,2021-01-18T00:00:00,40,40,0,40
ΙΩΑΝΝΙΝΩΝ,403,170,0,34,170,2021-01-18T00:00:00,2734,2734,0,2734
ΚΑΒΑΛΑΣ,104,59,0,4,59,2021-01-18T00:00:00,699,699,0,699
ΚΑΛΥΜΝΟΥ,1203,12,0,7,12,2021-01-18T00:00:00,145,145,0,145
ΚΑΡΔΙΤΣΑΣ,501,55,0,10,55,2021-01-18T00:00:00,644,644,0,644
ΚΑΡΠΑΘΟΥ,1204,0,0,0,0,2021-01-18T00:00:00,15,15,0,15
ΚΑΣΤΟΡΙΑΣ,302,28,0,7,28,2021-01-18T00:00:00,325,325,0,325
ΚΕΑΣ-ΚΥΘΝΟΥ,1205,0,0,0,0,2021-01-18T00:00:00,0,0,0,0
ΚΕΝΤΡΙΚΟΥ ΤΟΜΕΑ ΑΘΗΝΩΝ,905,686,176,-172,862,2021-01-18T00:00:00,19651,19651,178,19829
ΚΕΡΚΥΡΑΣ,603,65,0,10,65,2021-01-18T00:00:00,320,320,0,320
ΚΕΦΑΛΛΗΝΙΑΣ,604,20,0,-25,20,2021-01-18T00:00:00,240,240,0,240
ΚΙΛΚΙΣ,203,40,0,5,40,2021-01-18T00:00:00,380,380,0,380
ΚΟΖΑΝΗΣ,303,44,0,7,44,2021-01-18T00:00:00,784,784,0,784
ΚΟΡΙΝΘΙΑΣ,1003,30,0,10,30,2021-01-18T00:00:00,350,350,0,350
ΚΩ,1206,26,0,9,26,2021-01-18T00:00:00,133,133,0,133
ΛΑΚΩΝΙΑΣ,1004,73,0,43,73,2021-01-18T00:00:00,502,502,0,502
ΛΑΡΙΣΑΣ,502,155,0,35,155,2021-01-18T00:00:00,2001,2001,0,2001
ΛΑΣΙΘΙΟΥ,1302,40,0,0,40,2021-01-18T00:00:00,599,599,0,599
ΛΕΣΒΟΥ,1102,34,0,-1,34,2021-01-18T00:00:00,284,284,0,284
ΛΕΥΚΑΔΑΣ,605,20,0,5,20,2021-01-18T00:00:00,135,135,0,135
ΛΗΜΝΟΥ,1103,5,0,0,5,2021-01-18T00:00:00,173,173,0,173
ΜΑΓΝΗΣΙΑΣ,503,0,0,0,0,2021-01-18T00:00:00,633,633,0,633
ΜΕΣΣΗΝΙΑΣ,1005,55,0,10,55,2021-01-18T00:00:00,665,665,0,665
ΜΗΛΟΥ,1207,0,0,0,0,2021-01-18T00:00:00,0,0,0,0
ΜΥΚΟΝΟΥ,1208,0,0,0,0,2021-01-18T00:00:00,0,0,0,0
ΝΑΞΟΥ,1209,10,0,5,10,2021-01-18T00:00:00,60,60,0,60
ΝΗΣΩΝ,906,0,0,-15,0,2021-01-18T00:00:00,40,40,0,40
ΝΟΤΙΟΥ ΤΟΜΕΑ ΑΘΗΝΩΝ,907,65,0,-70,65,2021-01-18T00:00:00,1340,1340,0,1340
ΞΑΝΘΗΣ,105,55,0,10,55,2021-01-18T00:00:00,610,610,0,610
ΠΑΡΟΥ,1210,0,0,0,0,2021-01-18T00:00:00,0,0,0,0
ΠΕΙΡΑΙΩΣ,908,114,0,-31,114,2021-01-18T00:00:00,2965,2965,0,2965
ΠΕΛΛΑΣ,204,51,0,23,51,2021-01-18T00:00:00,604,604,0,604
ΠΙΕΡΙΑΣ,205,35,0,5,35,2021-01-18T00:00:00,468,468,0,468
ΠΡΕΒΕΖΑΣ,404,24,0,5,24,2021-01-18T00:00:00,363,363,0,363
ΡΕΘΥΜΝΟΥ,1303,25,0,10,25,2021-01-18T00:00:00,495,495,0,495
ΡΟΔΟΠΗΣ,106,25,0,0,25,2021-01-18T00:00:00,345,345,0,345
ΡΟΔΟΥ,1211,0,0,0,0,2021-01-18T00:00:00,435,435,0,435
ΣΑΜΟΥ,1104,10,0,0,10,2021-01-18T00:00:00,210,210,0,210
ΣΕΡΡΩΝ,206,40,0,0,40,2021-01-18T00:00:00,690,690,0,690
ΣΠΟΡΑΔΩΝ,504,0,0,0,0,2021-01-18T00:00:00,0,0,0,0
ΣΥΡΟΥ,1212,0,0,0,0,2021-01-18T00:00:00,170,170,0,170
ΤΗΝΟΥ,1213,0,0,0,0,2021-01-18T00:00:00,0,0,0,0
ΤΡΙΚΑΛΩΝ,505,75,0,30,75,2021-01-18T00:00:00,755,755,0,755
ΦΘΙΩΤΙΔΑΣ,804,53,0,17,53,2021-01-18T00:00:00,773,773,0,773
ΦΛΩΡΙΝΑΣ,304,20,0,-3,20,2021-01-18T00:00:00,284,284,0,284
ΦΩΚΙΔΑΣ,805,6,0,-9,6,2021-01-18T00:00:00,126,126,0,126
ΧΑΛΚΙΔΙΚΗΣ,207,15,0,-5,15,2021-01-18T00:00:00,280,280,0,280
ΧΑΝΙΩΝ,1304,60,0,6,60,2021-01-18T00:00:00,1043,1043,0,1043
ΧΙΟΥ,1105,27,0,7,27,2021-01-18T00:00:00,287,287,0,287
ΑΙΤΩΛΟΑΚΑΡΝΑΝΙΑΣ,701,54,0,14,54,2021-01-19T00:00:00,943,943,0,943
ΑΝΑΤΟΛΙΚΗΣ ΑΤΤΙΚΗΣ,901,47,85,35,132,2021-01-19T00:00:00,814,814,142,956
ΑΝΔΡΟΥ,1201,0,0,0,0,2021-01-19T00:00:00,0,0,0,0
ΑΡΓΟΛΙΔΑΣ,1001,131,0,80,131,2021-01-19T00:00:00,507,507,0,507
ΑΡΚΑΔΙΑΣ,1002,48,0,8,48,2021-01-19T00:00:00,613,613,0,613
ΑΡΤΑΣ,401,30,0,4,30,2021-01-19T00:00:00,646,646,0,646
ΑΧΑΪΑΣ,702,159,93,59,252,2021-01-19T00:00:00,2552,2552,93,2645
ΒΟΙΩΤΙΑΣ,801,59,0,23,59,2021-01-19T00:00:00,470,470,0,470
ΒΟΡΕΙΟΥ ΤΟΜΕΑ ΑΘΗΝΩΝ,902,1283,0,596,1283,2021-01-19T00:00:00,14318,14318,0,14318
ΓΡΕΒΕΝΩΝ,301,34,0,4,34,2021-01-19T00:00:00,279,279,0,279
ΔΡΑΜΑΣ,101,60,0,22,60,2021-01-19T00:00:00,523,523,0,523
ΔΥΤΙΚΗΣ ΑΤΤΙΚΗΣ,903,19,57,-24,76,2021-01-19T00:00:00,599,599,142,741
ΔΥΤΙΚΟΥ ΤΟΜΕΑ ΑΘΗΝΩΝ,904,204,51,88,255,2021-01-19T00:00:00,3075,3075,154,3229
ΕΒΡΟΥ,102,148,0,35,148,2021-01-19T00:00:00,1456,1456,0,1456
ΕΥΒΟΙΑΣ,802,200,0,97,200,2021-01-19T00:00:00,926,926,0,926
ΕΥΡΥΤΑΝΙΑΣ,803,36,0,21,36,2021-01-19T00:00:00,211,211,0,211
ΖΑΚΥΝΘΟΥ,601,60,0,40,60,2021-01-19T00:00:00,250,250,0,250
ΗΛΕΙΑΣ,703,133,0,63,133,2021-01-19T00:00:00,770,770,0,770
ΗΜΑΘΙΑΣ,201,60,0,10,60,2021-01-19T00:00:00,768,768,0,768
ΗΡΑΚΛΕΙΟΥ,1301,347,0,-102,347,2021-01-19T00:00:00,3383,3383,0,3383
ΘΑΣΟΥ,103,0,0,0,0,2021-01-19T00:00:00,0,0,0,0
ΘΕΣΠΡΩΤΙΑΣ,402,79,0,48,79,2021-01-19T00:00:00,385,385,0,385
ΘΕΣΣΑΛΟΝΙΚΗΣ,202,755,59,176,814,2021-01-19T00:00:00,12103,12103,59,12162
ΘΗΡΑΣ,1202,30,0,25,30,2021-01-19T00:00:00,65,65,0,65
ΙΘΑΚΗΣ,602,0,0,0,0,2021-01-19T00:00:00,0,0,0,0
ΙΚΑΡΙΑΣ,1101,24,0,19,24,2021-01-19T00:00:00,64,64,0,64
ΙΩΑΝΝΙΝΩΝ,403,139,76,45,215,2021-01-19T00:00:00,2873,2873,76,2949
ΚΑΒΑΛΑΣ,104,60,0,1,60,2021-01-19T00:00:00,759,759,0,759
ΚΑΛΥΜΝΟΥ,1203,6,0,-6,6,2021-01-19T00:00:00,151,151,0,151
ΚΑΡΔΙΤΣΑΣ,501,65,0,10,65,2021-01-19T00:00:00,709,709,0,709
ΚΑΡΠΑΘΟΥ,1204,0,0,0,0,2021-01-19T00:00:00,15,15,0,15
ΚΑΣΤΟΡΙΑΣ,302,30,0,2,30,2021-01-19T00:00:00,355,355,0,355
ΚΕΑΣ-ΚΥΘΝΟΥ,1205,0,0,0,0,2021-01-19T00:00:00,0,0,0,0
ΚΕΝΤΡΙΚΟΥ ΤΟΜΕΑ ΑΘΗΝΩΝ,905,963,133,234,1096,2021-01-19T00:00:00,20614,20614,311,20925
ΚΕΡΚΥΡΑΣ,603,108,0,43,108,2021-01-19T00:00:00,428,428,0,428
ΚΕΦΑΛΛΗΝΙΑΣ,604,130,0,110,130,2021-01-19T00:00:00,370,370,0,370
ΚΙΛΚΙΣ,203,66,0,26,66,2021-01-19T00:00:00,446,446,0,446
ΚΟΖΑΝΗΣ,303,121,0,77,121,2021-01-19T00:00:00,905,905,0,905
ΚΟΡΙΝΘΙΑΣ,1003,30,0,0,30,2021-01-19T00:00:00,380,380,0,380
ΚΩ,1206,60,0,34,60,2021-01-19T00:00:00,193,193,0,193
ΛΑΚΩΝΙΑΣ,1004,137,0,64,137,2021-01-19T00:00:00,639,639,0,639
ΛΑΡΙΣΑΣ,502,103,95,43,198,2021-01-19T00:00:00,2104,2104,95,2199
ΛΑΣΙΘΙΟΥ,1302,194,0,154,194,2021-01-19T00:00:00,793,793,0,793
ΛΕΣΒΟΥ,1102,168,0,134,168,2021-01-19T00:00:00,452,452,0,452
ΛΕΥΚΑΔΑΣ,605,36,0,16,36,2021-01-19T00:00:00,171,171,0,171
ΛΗΜΝΟΥ,1103,54,0,49,54,2021-01-19T00:00:00,227,227,0,227
ΜΑΓΝΗΣΙΑΣ,503,49,0,49,49,2021-01-19T00:00:00,682,682,0,682
ΜΕΣΣΗΝΙΑΣ,1005,105,0,50,105,2021-01-19T00:00:00,770,770,0,770
ΜΗΛΟΥ,1207,0,0,0,0,2021-01-19T00:00:00,0,0,0,0
ΜΥΚΟΝΟΥ,1208,0,0,0,0,2021-01-19T00:00:00,0,0,0,0
ΝΑΞΟΥ,1209,12,0,2,12,2021-01-19T00:00:00,72,72,0,72
ΝΗΣΩΝ,906,24,0,24,24,2021-01-19T00:00:00,64,64,0,64
ΝΟΤΙΟΥ ΤΟΜΕΑ ΑΘΗΝΩΝ,907,102,0,37,102,2021-01-19T00:00:00,1442,1442,0,1442
ΞΑΝΘΗΣ,105,60,0,5,60,2021-01-19T00:00:00,670,670,0,670
ΠΑΡΟΥ,1210,0,0,0,0,2021-01-19T00:00:00,0,0,0,0
ΠΕΙΡΑΙΩΣ,908,227,0,113,227,2021-01-19T00:00:00,3192,3192,0,3192
ΠΕΛΛΑΣ,204,80,0,29,80,2021-01-19T00:00:00,684,684,0,684
ΠΙΕΡΙΑΣ,205,54,0,19,54,2021-01-19T00:00:00,522,522,0,522
ΠΡΕΒΕΖΑΣ,404,48,0,24,48,2021-01-19T00:00:00,411,411,0,411
ΡΕΘΥΜΝΟΥ,1303,30,0,5,30,2021-01-19T00:00:00,525,525,0,525
ΡΟΔΟΠΗΣ,106,48,0,23,48,2021-01-19T00:00:00,393,393,0,393
ΡΟΔΟΥ,1211,90,0,90,90,2021-01-19T00:00:00,525,525,0,525
ΣΑΜΟΥ,1104,30,0,20,30,2021-01-19T00:00:00,240,240,0,240
ΣΕΡΡΩΝ,206,72,0,32,72,2021-01-19T00:00:00,762,762,0,762
ΣΠΟΡΑΔΩΝ,504,0,0,0,0,2021-01-19T00:00:00,0,0,0,0
ΣΥΡΟΥ,1212,29,0,29,29,2021-01-19T00:00:00,199,199,0,199
ΤΗΝΟΥ,1213,0,0,0,0,2021-01-19T00:00:00,0,0,0,0
ΤΡΙΚΑΛΩΝ,505,72,0,-3,72,2021-01-19T00:00:00,827,827,0,827
ΦΘΙΩΤΙΔΑΣ,804,61,0,8,61,2021-01-19T00:00:00,834,834,0,834
ΦΛΩΡΙΝΑΣ,304,30,0,10,30,2021-01-19T00:00:00,314,314,0,314
ΦΩΚΙΔΑΣ,805,48,0,42,48,2021-01-19T00:00:00,174,174,0,174
ΧΑΛΚΙΔΙΚΗΣ,207,30,0,15,30,2021-01-19T00:00:00,310,310,0,310
ΧΑΝΙΩΝ,1304,94,0,34,94,2021-01-19T00:00:00,1137,1137,0,1137
ΧΙΟΥ,1105,42,0,15,42,2021-01-19T00:00:00,329,329,0,329
ΑΙΤΩΛΟΑΚΑΡΝΑΝΙΑΣ,701,78,0,24,78,2021-01-20T00:00:00,1021,1021,0,1021
ΑΝΑΤΟΛΙΚΗΣ ΑΤΤΙΚΗΣ,901,276,40,184,316,2021-01-20T00:00:00,1090,1090,182,1272
ΑΝΔΡΟΥ,1201,0,0,0,0,2021-01-20T00:00:00,0,0,0,0
ΑΡΓΟΛΙΔΑΣ,1001,174,0,43,174,2021-01-20T00:00:00,681,681,0,681
ΑΡΚΑΔΙΑΣ,1002,108,0,60,108,2021-01-20T00:00:00,721,721,0,721
ΑΡΤΑΣ,401,132,0,102,132,2021-01-20T00:00:00,778,778,0,778
ΑΧΑΪΑΣ,702,439,95,282,534,2021-01-20T00:00:00,2991,2991,188,3179
ΒΟΙΩΤΙΑΣ,801,155,0,96,155,2021-01-20T00:00:00,625,625,0,625
ΒΟΡΕΙΟΥ ΤΟΜΕΑ ΑΘΗΝΩΝ,902,2191,0,908,2191,2021-01-20T00:00:00,16509,16509,0,16509
ΓΡΕΒΕΝΩΝ,301,36,0,2,36,2021-01-20T00:00:00,315,315,0,315
ΔΡΑΜΑΣ,101,168,0,108,168,2021-01-20T00:00:00,691,691,0,691
ΔΥΤΙΚΗΣ ΑΤΤΙΚΗΣ,903,122,53,99,175,2021-01-20T00:00:00,721,721,195,916
ΔΥΤΙΚΟΥ ΤΟΜΕΑ ΑΘΗΝΩΝ,904,444,40,229,484,2021-01-20T00:00:00,3519,3519,194,3713
ΕΒΡΟΥ,102,301,0,153,301,2021-01-20T00:00:00,1757,1757,0,1757
ΕΥΒΟΙΑΣ,802,434,0,234,434,2021-01-20T00:00:00,1360,1360,0,1360
ΕΥΡΥΤΑΝΙΑΣ,803,29,0,-7,29,2021-01-20T00:00:00,240,240,0,240
ΖΑΚΥΝΘΟΥ,601,102,0,42,102,2021-01-20T00:00:00,352,352,0,352
ΗΛΕΙΑΣ,703,198,0,65,198,2021-01-20T00:00:00,968,968,0,968
ΗΜΑΘΙΑΣ,201,135,0,75,135,2021-01-20T00:00:00,903,903,0,903
ΗΡΑΚΛΕΙΟΥ,1301,488,0,141,488,2021-01-20T00:00:00,3871,3871,0,3871
ΘΑΣΟΥ,103,0,0,0,0,2021-01-20T00:00:00,0,0,0,0
ΘΕΣΠΡΩΤΙΑΣ,402,96,0,17,96,2021-01-20T00:00:00,481,481,0,481
ΘΕΣΣΑΛΟΝΙΚΗΣ,202,1468,79,733,1547,2021-01-20T00:00:00,13571,13571,138,13709
ΘΗΡΑΣ,1202,18,0,-12,18,2021-01-20T00:00:00,83,83,0,83
ΙΘΑΚΗΣ,602,0,0,0,0,2021-01-20T00:00:00,0,0,0,0
ΙΚΑΡΙΑΣ,1101,17,0,-7,17,2021-01-20T00:00:00,81,81,0,81
ΙΩΑΝΝΙΝΩΝ,403,236,93,114,329,2021-01-20T00:00:00,3109,3109,169,3278
ΚΑΒΑΛΑΣ,104,148,0,88,148,2021-01-20T00:00:00,907,907,0,907
ΚΑΛΥΜΝΟΥ,1203,33,0,27,33,2021-01-20T00:00:00,184,184,0,184
ΚΑΡΔΙΤΣΑΣ,501,234,0,169,234,2021-01-20T00:00:00,943,943,0,943
ΚΑΡΠΑΘΟΥ,1204,12,0,12,12,2021-01-20T00:00:00,27,27,0,27
ΚΑΣΤΟΡΙΑΣ,302,59,0,29,59,2021-01-20T00:00:00,414,414,0,414
ΚΕΑΣ-ΚΥΘΝΟΥ,1205,0,0,0,0,2021-01-20T00:00:00,0,0,0,0
ΚΕΝΤΡΙΚΟΥ ΤΟΜΕΑ ΑΘΗΝΩΝ,905,1640,97,641,1737,2021-01-20T00:00:00,22254,22254,408,22662
ΚΕΡΚΥΡΑΣ,603,231,0,123,231,2021-01-20T00:00:00,659,659,0,659
ΚΕΦΑΛΛΗΝΙΑΣ,604,137,0,7,137,2021-01-20T00:00:00,507,507,0,507
ΚΙΛΚΙΣ,203,202,0,136,202,2021-01-20T00:00:00,648,648,0,648
ΚΟΖΑΝΗΣ,303,114,0,-7,114,2021-01-20T00:00:00,1019,1019,0,1019
ΚΟΡΙΝΘΙΑΣ,1003,71,0,41,71,2021-01-20T00:00:00,451,451,0,451
ΚΩ,1206,66,0,6,66,2021-01-20T00:00:00,259,259,0,259
ΛΑΚΩΝΙΑΣ,1004,156,0,19,156,2021-01-20T00:00:00,795,795,0,795
ΛΑΡΙΣΑΣ,502,211,95,108,306,2021-01-20T00:00:00,2315,2315,190,2505
ΛΑΣΙΘΙΟΥ,1302,253,0,59,253,2021-01-20T00:00:00,1046,1046,0,1046
ΛΕΣΒΟΥ,1102,151,0,-17,151,2021-01-20T00:00:00,603,603,0,603
ΛΕΥΚΑΔΑΣ,605,47,0,11,47,2021-01-20T00:00:00,218,218,0,218
ΛΗΜΝΟΥ,1103,42,0,-12,42,2021-01-20T00:00:00,269,269,0,269
ΜΑΓΝΗΣΙΑΣ,503,78,0,29,78,2021-01-20T00:00:00,760,760,0,760
ΜΕΣΣΗΝΙΑΣ,1005,175,0,70,175,2021-01-20T00:00:00,945,945,0,945
ΜΗΛΟΥ,1207,0,0,0,0,2021-01-20T00:00:00,0,0,0,0
ΜΥΚΟΝΟΥ,1208,0,0,0,0,2021-01-20T00:00:00,0,0,0,0
ΝΑΞΟΥ,1209,30,0,18,30,2021-01-20T00:00:00,102,102,0,102
ΝΗΣΩΝ,906,18,0,-6,18,2021-01-20T00:00:00,82,82,0,82
ΝΟΤΙΟΥ ΤΟΜΕΑ ΑΘΗΝΩΝ,907,272,0,170,272,2021-01-20T00:00:00,1714,1714,0,1714
ΞΑΝΘΗΣ,105,117,0,57,117,2021-01-20T00:00:00,787,787,0,787
ΠΑΡΟΥ,1210,0,0,0,0,2021-01-20T00:00:00,0,0,0,0
ΠΕΙΡΑΙΩΣ,908,636,0,409,636,2021-01-20T00:00:00,3828,3828,0,3828
ΠΕΛΛΑΣ,204,196,0,116,196,2021-01-20T00:00:00,880,880,0,880
ΠΙΕΡΙΑΣ,205,108,0,54,108,2021-01-20T00:00:00,630,630,0,630
ΠΡΕΒΕΖΑΣ,404,48,0,0,48,2021-01-20T00:00:00,459,459,0,459
ΡΕΘΥΜΝΟΥ,1303,150,0,120,150,2021-01-20T00:00:00,675,675,0,675
ΡΟΔΟΠΗΣ,106,90,0,42,90,2021-01-20T00:00:00,483,483,0,483
ΡΟΔΟΥ,1211,96,0,6,96,2021-01-20T00:00:00,621,621,0,621
ΣΑΜΟΥ,1104,48,0,18,48,2021-01-20T00:00:00,288,288,0,288
ΣΕΡΡΩΝ,206,126,0,54,126,2021-01-20T00:00:00,888,888,0,888
ΣΠΟΡΑΔΩΝ,504,0,0,0,0,2021-01-20T00:00:00,0,0,0,0
ΣΥΡΟΥ,1212,48,0,19,48,2021-01-20T00:00:00,247,247,0,247
ΤΗΝΟΥ,1213,0,0,0,0,2021-01-20T00:00:00,0,0,0,0
ΤΡΙΚΑΛΩΝ,505,179,0,107,179,2021-01-20T00:00:00,1006,1006,0,1006
ΦΘΙΩΤΙΔΑΣ,804,139,0,78,139,2021-01-20T00:00:00,973,973,0,973
ΦΛΩΡΙΝΑΣ,304,66,0,36,66,2021-01-20T00:00:00,380,380,0,380
ΦΩΚΙΔΑΣ,805,48,0,0,48,2021-01-20T00:00:00,222,222,0,222
ΧΑΛΚΙΔΙΚΗΣ,207,90,0,60,90,2021-01-20T00:00:00,400,400,0,400
ΧΑΝΙΩΝ,1304,345,0,251,345,2021-01-20T00:00:00,1482,1482,0,1482
ΧΙΟΥ,1105,30,0,-12,30,2021-01-20T00:00:00,359,359,0,359
ΑΙΤΩΛΟΑΚΑΡΝΑΝΙΑΣ,701,0,0,-386,0,2021-03-25T00:00:00,13397,13397,4937,18334
ΑΝΑΤΟΛΙΚΗΣ ΑΤΤΙΚΗΣ,901,1,0,-813,1,2021-03-25T00:00:00,29137,29137,10636,39773
ΑΝΔΡΟΥ,1201,0,0,-49,0,2021-03-25T00:00:00,418,418,296,714
ΑΡΓΟΛΙΔΑΣ,1001,0,0,-224,0,2021-03-25T00:00:00,8206,8206,3579,11785
ΑΡΚΑΔΙΑΣ,1002,0,0,-223,0,2021-03-25T00:00:00,8167,8167,3352,11519
ΑΡΤΑΣ,401,0,0,-178,0,2021-03-25T00:00:00,6171,6171,3814,9985
ΑΧΑΪΑΣ,702,0,0,-855,0,2021-03-25T00:00:00,24076,24076,12353,36429
ΒΟΙΩΤΙΑΣ,801,0,0,-293,0,2021-03-25T00:00:00,11469,11469,3788,15257
ΒΟΡΕΙΟΥ ΤΟΜΕΑ ΑΘΗΝΩΝ,902,10,5,-4983,15,2021-03-25T00:00:00,133747,133748,71395,205143
ΓΡΕΒΕΝΩΝ,301,0,0,-86,0,2021-03-25T00:00:00,3420,3420,1605,5025
ΔΡΑΜΑΣ,101,0,0,-239,0,2021-03-25T00:00:00,8019,8019,4154,12173
ΔΥΤΙΚΗΣ ΑΤΤΙΚΗΣ,903,0,0,-302,0,2021-03-25T00:00:00,8816,8816,3752,12568
ΔΥΤΙΚΟΥ ΤΟΜΕΑ ΑΘΗΝΩΝ,904,0,0,-1379,0,2021-03-25T00:00:00,42466,42466,19653,62119
ΕΒΡΟΥ,102,0,0,-437,0,2021-03-25T00:00:00,14596,14596,7172,21768
ΕΥΒΟΙΑΣ,802,0,0,-580,0,2021-03-25T00:00:00,17089,17089,7997,25086
ΕΥΡΥΤΑΝΙΑΣ,803,0,0,-42,0,2021-03-25T00:00:00,1712,1712,829,2541
ΖΑΚΥΝΘΟΥ,601,0,0,-139,0,2021-03-25T00:00:00,2888,2888,1705,4593
ΗΛΕΙΑΣ,703,0,0,-374,0,2021-03-25T00:00:00,10788,10788,4832,15620
ΗΜΑΘΙΑΣ,201,0,0,-368,0,2021-03-25T00:00:00,11539,11539,5792,17331
ΗΡΑΚΛΕΙΟΥ,1301,0,0,-805,0,2021-03-25T00:00:00,24450,24450,12768,37218
ΘΑΣΟΥ,103,0,0,-48,0,2021-03-25T00:00:00,548,548,452,1000
ΘΕΣΠΡΩΤΙΑΣ,402,0,0,-243,0,2021-03-25T00:00:00,6110,6110,2675,8785
ΘΕΣΣΑΛΟΝΙΚΗΣ,202,0,0,-3799,0,2021-03-25T00:00:00,112391,112393,58840,171233
ΘΗΡΑΣ,1202,0,0,-42,0,2021-03-25T00:00:00,1139,1139,489,1628
ΙΘΑΚΗΣ,602,0,0,-66,0,2021-03-25T00:00:00,812,812,364,1176
ΙΚΑΡΙΑΣ,1101,0,0,-40,0,2021-03-25T00:00:00,1465,1465,925,2390
ΙΩΑΝΝΙΝΩΝ,403,0,0,-523,0,2021-03-25T00:00:00,17504,17505,9922,27427
ΚΑΒΑΛΑΣ,104,0,0,-360,0,2021-03-25T00:00:00,10340,10340,5467,15807
ΚΑΛΥΜΝΟΥ,1203,0,0,-28,0,2021-03-25T00:00:00,1566,1566,1103,2669
ΚΑΡΔΙΤΣΑΣ,501,1,0,-295,1,2021-03-25T00:00:00,12649,12649,5147,17796
ΚΑΡΠΑΘΟΥ,1204,0,0,-107,0,2021-03-25T00:00:00,589,589,333,922
ΚΑΣΤΟΡΙΑΣ,302,0,0,-212,0,2021-03-25T00:00:00,6045,6045,2609,8654
ΚΕΑΣ-ΚΥΘΝΟΥ,1205,0,0,-78,0,2021-03-25T00:00:00,545,545,38,583
ΚΕΝΤΡΙΚΟΥ ΤΟΜΕΑ ΑΘΗΝΩΝ,905,60,1,-3898,61,2021-03-25T00:00:00,144648,144649,75580,220229
ΚΕΡΚΥΡΑΣ,603,0,0,-343,0,2021-03-25T00:00:00,8915,8915,3993,12908
ΚΕΦΑΛΛΗΝΙΑΣ,604,0,0,-122,0,2021-03-25T00:00:00,4157,4157,2051,6208
ΚΙΛΚΙΣ,203,0,0,-208,0,2021-03-25T00:00:00,7969,7969,4047,12016
ΚΟΖΑΝΗΣ,303,0,0,-402,0,2021-03-25T00:00:00,12958,12958,5669,18627
ΚΟΡΙΝΘΙΑΣ,1003,0,0,-278,0,2021-03-25T00:00:00,10242,10242,3648,13890
ΚΩ,1206,0,1,-136,1,2021-03-25T00:00:00,3363,3363,1520,4883
ΛΑΚΩΝΙΑΣ,1004,0,0,-167,0,2021-03-25T00:00:00,8061,8061,3702,11763
ΛΑΡΙΣΑΣ,502,0,0,-578,0,2021-03-25T00:00:00,21104,21104,9266,30370
ΛΑΣΙΘΙΟΥ,1302,0,0,-335,0,2021-03-25T00:00:00,8847,8847,5112,13959
ΛΕΣΒΟΥ,1102,0,0,-205,0,2021-03-25T00:00:00,6504,6504,3019,9523
ΛΕΥΚΑΔΑΣ,605,0,0,-184,0,2021-03-25T00:00:00,3541,3541,1855,5396
ΛΗΜΝΟΥ,1103,0,0,-66,0,2021-03-25T00:00:00,1650,1650,908,2558
ΜΑΓΝΗΣΙΑΣ,503,0,0,-525,0,2021-03-25T00:00:00,14245,14245,6207,20452
ΜΕΣΣΗΝΙΑΣ,1005,0,0,-335,0,2021-03-25T00:00:00,12278,12278,6201,18479
ΜΗΛΟΥ,1207,0,0,-48,0,2021-03-25T00:00:00,1393,1393,294,1687
ΜΥΚΟΝΟΥ,1208,0,0,-48,0,2021-03-25T00:00:00,284,284,167,451
ΝΑΞΟΥ,1209,0,0,-42,0,2021-03-25T00:00:00,892,892,558,1450
ΝΗΣΩΝ,906,0,0,-264,0,2021-03-25T00:00:00,4781,4781,2099,6880
ΝΟΤΙΟΥ ΤΟΜΕΑ ΑΘΗΝΩΝ,907,0,0,-938,0,2021-03-25T00:00:00,27737,27737,10660,38397
ΞΑΝΘΗΣ,105,0,0,-252,0,2021-03-25T00:00:00,6779,6779,3424,10203
ΠΑΡΟΥ,1210,0,0,-54,0,2021-03-25T00:00:00,421,421,311,732
ΠΕΙΡΑΙΩΣ,908,0,0,-1345,0,2021-03-25T00:00:00,43088,43088,18917,62005
ΠΕΛΛΑΣ,204,26,15,-270,41,2021-03-25T00:00:00,13258,13258,6272,19530
ΠΙΕΡΙΑΣ,205,0,0,-305,0,2021-03-25T00:00:00,9137,9137,4764,13901
ΠΡΕΒΕΖΑΣ,404,0,0,-161,0,2021-03-25T00:00:00,5712,5712,1516,7228
ΡΕΘΥΜΝΟΥ,1303,0,0,-196,0,2021-03-25T00:00:00,7596,7596,3554,11150
ΡΟΔΟΠΗΣ,106,0,0,-237,0,2021-03-25T00:00:00,6369,6369,3074,9443
ΡΟΔΟΥ,1211,15,0,-235,15,2021-03-25T00:00:00,7875,7875,3987,11862
ΣΑΜΟΥ,1104,0,0,-60,0,2021-03-25T00:00:00,2587,2587,1046,3633
ΣΕΡΡΩΝ,206,1,0,-332,1,2021-03-25T00:00:00,12398,12398,4795,17193
ΣΠΟΡΑΔΩΝ,504,0,0,-138,0,2021-03-25T00:00:00,713,713,349,1062
ΣΥΡΟΥ,1212,0,0,-90,0,2021-03-25T00:00:00,2036,2036,976,3012
ΤΗΝΟΥ,1213,0,0,-54,0,2021-03-25T00:00:00,422,422,315,737
ΤΡΙΚΑΛΩΝ,505,0,0,-392,0,2021-03-25T00:00:00,12462,12462,6093,18555
ΦΘΙΩΤΙΔΑΣ,804,0,0,-413,0,2021-03-25T00:00:00,10919,10919,5103,16022
ΦΛΩΡΙΝΑΣ,304,0,0,-155,0,2021-03-25T00:00:00,4868,4868,2277,7145
ΦΩΚΙΔΑΣ,805,0,0,-64,0,2021-03-25T00:00:00,2694,2694,1263,3957
ΧΑΛΚΙΔΙΚΗΣ,207,0,0,-226,0,2021-03-25T00:00:00,9189,9189,3669,12858
ΧΑΝΙΩΝ,1304,0,0,-470,0,2021-03-25T00:00:00,16356,16356,8038,24394
ΧΙΟΥ,1105,2,9,-156,11,2021-03-25T00:00:00,4937,4937,2368,7305
ΑΙΤΩΛΟΑΚΑΡΝΑΝΙΑΣ,701,237,131,368,368,2021-03-26T00:00:00,13634,13634,5068,18702
ΑΝΑΤΟΛΙΚΗΣ ΑΤΤΙΚΗΣ,901,392,500,891,892,2021-03-26T00:00:00,29529,29529,11136,40665
ΑΝΔΡΟΥ,1201,46,0,46,46,2021-03-26T00:00:00,464,464,296,760
ΑΡΓΟΛΙΔΑΣ,1001,94,161,255,255,2021-03-26T00:00:00,8300,8300,3740,12040
ΑΡΚΑΔΙΑΣ,1002,103,151,254,254,2021-03-26T00:00:00,8270,8270,3503,11773
ΑΡΤΑΣ,401,36,158,194,194,2021-03-26T00:00:00,6207,6207,3972,10179
ΑΧΑΪΑΣ,702,266,598,864,864,2021-03-26T00:00:00,24342,24342,12951,37293
ΒΟΙΩΤΙΑΣ,801,116,210,326,326,2021-03-26T00:00:00,11585,11585,3998,15583
ΒΟΡΕΙΟΥ ΤΟΜΕΑ ΑΘΗΝΩΝ,902,742,4231,4958,4973,2021-03-26T00:00:00,134489,134490,75626,210116
ΓΡΕΒΕΝΩΝ,301,18,107,125,125,2021-03-26T00:00:00,3438,3438,1712,5150
ΔΡΑΜΑΣ,101,60,166,226,226,2021-03-26T00:00:00,8079,8079,4320,12399
ΔΥΤΙΚΗΣ ΑΤΤΙΚΗΣ,903,75,328,403,403,2021-03-26T00:00:00,8891,8891,4080,12971
ΔΥΤΙΚΟΥ ΤΟΜΕΑ ΑΘΗΝΩΝ,904,341,1092,1433,1433,2021-03-26T00:00:00,42807,42807,20745,63552
ΕΒΡΟΥ,102,97,308,405,405,2021-03-26T00:00:00,14693,14693,7480,22173
ΕΥΒΟΙΑΣ,802,205,509,714,714,2021-03-26T00:00:00,17294,17294,8506,25800
ΕΥΡΥΤΑΝΙΑΣ,803,7,52,59,59,2021-03-26T00:00:00,1719,1719,881,2600
ΖΑΚΥΝΘΟΥ,601,58,93,151,151,2021-03-26T00:00:00,2946,2946,1798,4744
ΗΛΕΙΑΣ,703,126,257,383,383,2021-03-26T00:00:00,10914,10914,5089,16003
ΗΜΑΘΙΑΣ,201,125,219,344,344,2021-03-26T00:00:00,11664,11664,6011,17675
ΗΡΑΚΛΕΙΟΥ,1301,325,532,857,857,2021-03-26T00:00:00,24775,24775,13300,38075
ΘΑΣΟΥ,103,54,0,54,54,2021-03-26T00:00:00,602,602,452,1054
ΘΕΣΠΡΩΤΙΑΣ,402,60,205,265,265,2021-03-26T00:00:00,6170,6170,2880,9050
ΘΕΣΣΑΛΟΝΙΚΗΣ,202,1061,3141,4202,4202,2021-03-26T00:00:00,113452,113454,61981,175435
ΘΗΡΑΣ,1202,1,47,48,48,2021-03-26T00:00:00,1140,1140,536,1676
ΙΘΑΚΗΣ,602,2,70,72,72,2021-03-26T00:00:00,814,814,434,1248
ΙΚΑΡΙΑΣ,1101,1,48,49,49,2021-03-26T00:00:00,1466,1466,973,2439
ΙΩΑΝΝΙΝΩΝ,403,185,362,547,547,2021-03-26T00:00:00,17689,17690,10284,27974
ΚΑΒΑΛΑΣ,104,137,230,367,367,2021-03-26T00:00:00,10477,10477,5697,16174
ΚΑΛΥΜΝΟΥ,1203,1,101,102,102,2021-03-26T00:00:00,1567,1567,1204,2771
ΚΑΡΔΙΤΣΑΣ,501,107,209,315,316,2021-03-26T00:00:00,12756,12756,5356,18112
ΚΑΡΠΑΘΟΥ,1204,20,34,54,54,2021-03-26T00:00:00,609,609,367,976
ΚΑΣΤΟΡΙΑΣ,302,67,163,230,230,2021-03-26T00:00:00,6112,6112,2772,8884
ΚΕΑΣ-ΚΥΘΝΟΥ,1205,28,2,30,30,2021-03-26T00:00:00,573,573,40,613
ΚΕΝΤΡΙΚΟΥ ΤΟΜΕΑ ΑΘΗΝΩΝ,905,1455,2796,4190,4251,2021-03-26T00:00:00,146103,146104,78376,224480
ΚΕΡΚΥΡΑΣ,603,68,313,381,381,2021-03-26T00:00:00,8983,8983,4306,13289
ΚΕΦΑΛΛΗΝΙΑΣ,604,12,147,159,159,2021-03-26T00:00:00,4169,4169,2198,6367
ΚΙΛΚΙΣ,203,25,379,404,404,2021-03-26T00:00:00,7994,7994,4426,12420
ΚΟΖΑΝΗΣ,303,128,253,381,381,2021-03-26T00:00:00,13086,13086,5922,19008
ΚΟΡΙΝΘΙΑΣ,1003,137,164,301,301,2021-03-26T00:00:00,10379,10379,3812,14191
ΚΩ,1206,27,161,187,188,2021-03-26T00:00:00,3390,3390,1681,5071
ΛΑΚΩΝΙΑΣ,1004,51,145,196,196,2021-03-26T00:00:00,8112,8112,3847,11959
ΛΑΡΙΣΑΣ,502,288,283,571,571,2021-03-26T00:00:00,21392,21392,9549,30941
ΛΑΣΙΘΙΟΥ,1302,83,293,376,376,2021-03-26T00:00:00,8930,8930,5405,14335
ΛΕΣΒΟΥ,1102,58,158,216,216,2021-03-26T00:00:00,6562,6562,3177,9739
ΛΕΥΚΑΔΑΣ,605,13,51,64,64,2021-03-26T00:00:00,3554,3554,1906,5460
ΛΗΜΝΟΥ,1103,30,59,89,89,2021-03-26T00:00:00,1680,1680,967,2647
ΜΑΓΝΗΣΙΑΣ,503,178,332,510,510,2021-03-26T00:00:00,14423,14423,6539,20962
ΜΕΣΣΗΝΙΑΣ,1005,88,269,357,357,2021-03-26T00:00:00,12366,12366,6470,18836
ΜΗΛΟΥ,1207,87,54,141,141,2021-03-26T00:00:00,1480,1480,348,1828
ΜΥΚΟΝΟΥ,1208,55,5,60,60,2021-03-26T00:00:00,339,339,172,511
ΝΑΞΟΥ,1209,5,49,54,54,2021-03-26T00:00:00,897,897,607,1504
ΝΗΣΩΝ,906,161,147,308,308,2021-03-26T00:00:00,4942,4942,2246,7188
ΝΟΤΙΟΥ ΤΟΜΕΑ ΑΘΗΝΩΝ,907,493,364,857,857,2021-03-26T00:00:00,28230,28230,11024,39254
ΞΑΝΘΗΣ,105,69,199,268,268,2021-03-26T00:00:00,6848,6848,3623,10471
ΠΑΡΟΥ,1210,52,2,54,54,2021-03-26T00:00:00,473,473,313,786
ΠΕΙΡΑΙΩΣ,908,398,975,1373,1373,2021-03-26T00:00:00,43486,43486,19892,63378
ΠΕΛΛΑΣ,204,36,342,337,378,2021-03-26T00:00:00,13294,13294,6614,19908
ΠΙΕΡΙΑΣ,205,102,223,325,325,2021-03-26T00:00:00,9239,9239,4987,14226
ΠΡΕΒΕΖΑΣ,404,105,56,161,161,2021-03-26T00:00:00,5817,5817,1572,7389
ΡΕΘΥΜΝΟΥ,1303,49,219,268,268,2021-03-26T00:00:00,7645,7645,3773,11418
ΡΟΔΟΠΗΣ,106,96,122,218,218,2021-03-26T00:00:00,6465,6465,3196,9661
ΡΟΔΟΥ,1211,142,162,289,304,2021-03-26T00:00:00,8017,8017,4149,12166
ΣΑΜΟΥ,1104,18,54,72,72,2021-03-26T00:00:00,2605,2605,1100,3705
ΣΕΡΡΩΝ,206,150,194,343,344,2021-03-26T00:00:00,12548,12548,4989,17537
ΣΠΟΡΑΔΩΝ,504,94,2,96,96,2021-03-26T00:00:00,807,807,351,1158
ΣΥΡΟΥ,1212,56,57,113,113,2021-03-26T00:00:00,2092,2092,1033,3125
ΤΗΝΟΥ,1213,54,0,54,54,2021-03-26T00:00:00,476,476,315,791
ΤΡΙΚΑΛΩΝ,505,148,233,381,381,2021-03-26T00:00:00,12610,12610,6326,18936
ΦΘΙΩΤΙΔΑΣ,804,152,229,381,381,2021-03-26T00:00:00,11071,11071,5332,16403
ΦΛΩΡΙΝΑΣ,304,0,156,156,156,2021-03-26T00:00:00,4868,4868,2433,7301
ΦΩΚΙΔΑΣ,805,12,46,58,58,2021-03-26T00:00:00,2706,2706,1309,4015
ΧΑΛΚΙΔΙΚΗΣ,207,42,312,354,354,2021-03-26T00:00:00,9231,9231,3981,13212
ΧΑΝΙΩΝ,1304,149,431,580,580,2021-03-26T00:00:00,16505,16505,8469,24974
ΧΙΟΥ,1105,74,138,201,212,2021-03-26T00:00:00,5010,5011,2506,7517
ΑΙΤΩΛΟΑΚΑΡΝΑΝΙΑΣ,701,222,118,-28,340,2021-03-27T00:00:00,13856,13856,5186,19042
ΑΝΑΤΟΛΙΚΗΣ ΑΤΤΙΚΗΣ,901,317,441,-134,758,2021-03-27T00:00:00,29846,29846,11577,41423
ΑΝΔΡΟΥ,1201,48,0,2,48,2021-03-27T00:00:00,512,512,296,808
ΑΡΓΟΛΙΔΑΣ,1001,81,154,-20,235,2021-03-27T00:00:00,8381,8381,3894,12275
ΑΡΚΑΔΙΑΣ,1002,84,151,-19,235,2021-03-27T00:00:00,8354,8354,3654,12008
ΑΡΤΑΣ,401,13,154,-27,167,2021-03-27T00:00:00,6220,6220,4126,10346
ΑΧΑΪΑΣ,702,264,549,-51,813,2021-03-27T00:00:00,24606,24606,13500,38106
ΒΟΙΩΤΙΑΣ,801,107,201,-18,308,2021-03-27T00:00:00,11692,11692,4199,15891
ΒΟΡΕΙΟΥ ΤΟΜΕΑ ΑΘΗΝΩΝ,902,512,3318,-1143,3830,2021-03-27T00:00:00,135001,135002,78944,213946
ΓΡΕΒΕΝΩΝ,301,18,109,2,127,2021-03-27T00:00:00,3456,3456,1821,5277
ΔΡΑΜΑΣ,101,61,193,28,254,2021-03-27T00:00:00,8140,8140,4513,12653
ΔΥΤΙΚΗΣ ΑΤΤΙΚΗΣ,903,70,295,-38,365,2021-03-27T00:00:00,8961,8961,4375,13336
ΔΥΤΙΚΟΥ ΤΟΜΕΑ ΑΘΗΝΩΝ,904,322,959,-152,1281,2021-03-27T00:00:00,43129,43129,21704,64833
ΕΒΡΟΥ,102,96,339,30,435,2021-03-27T00:00:00,14789,14789,7819,22608
ΕΥΒΟΙΑΣ,802,174,438,-102,612,2021-03-27T00:00:00,17468,17468,8944,26412
ΕΥΡΥΤΑΝΙΑΣ,803,10,49,0,59,2021-03-27T00:00:00,1729,1729,930,2659
ΖΑΚΥΝΘΟΥ,601,52,101,2,153,2021-03-27T00:00:00,2998,2998,1899,4897
ΗΛΕΙΑΣ,703,119,253,-11,372,2021-03-27T00:00:00,11033,11033,5342,16375
ΗΜΑΘΙΑΣ,201,86,211,-47,297,2021-03-27T00:00:00,11750,11750,6222,17972
ΗΡΑΚΛΕΙΟΥ,1301,302,511,-44,813,2021-03-27T00:00:00,25077,25077,13811,38888
ΘΑΣΟΥ,103,58,2,6,60,2021-03-27T00:00:00,660,660,454,1114
ΘΕΣΠΡΩΤΙΑΣ,402,58,211,4,269,2021-03-27T00:00:00,6228,6228,3091,9319
ΘΕΣΣΑΛΟΝΙΚΗΣ,202,1071,2801,-330,3872,2021-03-27T00:00:00,114523,114525,64782,179307
ΘΗΡΑΣ,1202,40,44,36,84,2021-03-27T00:00:00,1180,1180,580,1760
ΙΘΑΚΗΣ,602,12,30,-30,42,2021-03-27T00:00:00,826,826,464,1290
ΙΚΑΡΙΑΣ,1101,9,48,8,57,2021-03-27T00:00:00,1475,1475,1021,2496
ΙΩΑΝΝΙΝΩΝ,403,162,355,-30,517,2021-03-27T00:00:00,17851,17852,10639,28491
ΚΑΒΑΛΑΣ,104,143,212,-12,355,2021-03-27T00:00:00,10620,10620,5909,16529
ΚΑΛΥΜΝΟΥ,1203,2,69,-31,71,2021-03-27T00:00:00,1569,1569,1273,2842
ΚΑΡΔΙΤΣΑΣ,501,87,204,-25,291,2021-03-27T00:00:00,12843,12843,5560,18403
ΚΑΡΠΑΘΟΥ,1204,49,23,18,72,2021-03-27T00:00:00,658,658,390,1048
ΚΑΣΤΟΡΙΑΣ,302,57,161,-12,218,2021-03-27T00:00:00,6169,6169,2933,9102
ΚΕΑΣ-ΚΥΘΝΟΥ,1205,125,0,95,125,2021-03-27T00:00:00,698,698,40,738
ΚΕΝΤΡΙΚΟΥ ΤΟΜΕΑ ΑΘΗΝΩΝ,905,1304,2350,-597,3654,2021-03-27T00:00:00,147407,147408,80726,228134
ΚΕΡΚΥΡΑΣ,603,78,253,-50,331,2021-03-27T00:00:00,9061,9061,4559,13620
ΚΕΦΑΛΛΗΝΙΑΣ,604,1,131,-27,132,2021-03-27T00:00:00,4170,4170,2329,6499
ΚΙΛΚΙΣ,203,12,284,-108,296,2021-03-27T00:00:00,8006,8006,4710,12716
ΚΟΖΑΝΗΣ,303,123,267,9,390,2021-03-27T00:00:00,13209,13209,6189,19398
ΚΟΡΙΝΘΙΑΣ,1003,128,157,-16,285,2021-03-27T00:00:00,10507,10507,3969,14476
ΚΩ,1206,22,102,-64,124,2021-03-27T00:00:00,3412,3412,1783,5195
ΛΑΚΩΝΙΑΣ,1004,39,152,-5,191,2021-03-27T00:00:00,8151,8151,3999,12150
ΛΑΡΙΣΑΣ,502,234,220,-117,454,2021-03-27T00:00:00,21626,21626,9769,31395
ΛΑΣΙΘΙΟΥ,1302,63,300,-13,363,2021-03-27T00:00:00,8993,8993,5705,14698
ΛΕΣΒΟΥ,1102,52,154,-10,206,2021-03-27T00:00:00,6614,6614,3331,9945
ΛΕΥΚΑΔΑΣ,605,16,49,1,65,2021-03-27T00:00:00,3570,3570,1955,5525
ΛΗΜΝΟΥ,1103,29,58,-2,87,2021-03-27T00:00:00,1709,1709,1025,2734
ΜΑΓΝΗΣΙΑΣ,503,178,260,-72,438,2021-03-27T00:00:00,14601,14601,6799,21400
ΜΕΣΣΗΝΙΑΣ,1005,89,258,-10,347,2021-03-27T00:00:00,12455,12455,6728,19183
ΜΗΛΟΥ,1207,44,4,-93,48,2021-03-27T00:00:00,1524,1524,352,1876
ΜΥΚΟΝΟΥ,1208,54,0,-6,54,2021-03-27T00:00:00,393,393,172,565
ΝΑΞΟΥ,1209,1,53,0,54,2021-03-27T00:00:00,898,898,660,1558
ΝΗΣΩΝ,906,120,104,-84,224,2021-03-27T00:00:00,5062,5062,2350,7412
ΝΟΤΙΟΥ ΤΟΜΕΑ ΑΘΗΝΩΝ,907,465,275,-117,740,2021-03-27T00:00:00,28695,28695,11299,39994
ΞΑΝΘΗΣ,105,33,189,-46,222,2021-03-27T00:00:00,6881,6881,3812,10693
ΠΑΡΟΥ,1210,45,3,-6,48,2021-03-27T00:00:00,518,518,316,834
ΠΕΙΡΑΙΩΣ,908,377,954,-42,1331,2021-03-27T00:00:00,43863,43863,20846,64709
ΠΕΛΛΑΣ,204,17,267,-94,284,2021-03-27T00:00:00,13311,13311,6881,20192
ΠΙΕΡΙΑΣ,205,97,215,-13,312,2021-03-27T00:00:00,9336,9336,5202,14538
ΠΡΕΒΕΖΑΣ,404,81,58,-22,139,2021-03-27T00:00:00,5898,5898,1630,7528
ΡΕΘΥΜΝΟΥ,1303,4,228,-36,232,2021-03-27T00:00:00,7649,7649,4001,11650
ΡΟΔΟΠΗΣ,106,75,103,-40,178,2021-03-27T00:00:00,6540,6540,3299,9839
ΡΟΔΟΥ,1211,114,216,26,330,2021-03-27T00:00:00,8131,8131,4365,12496
ΣΑΜΟΥ,1104,9,52,-11,61,2021-03-27T00:00:00,2614,2614,1152,3766
ΣΕΡΡΩΝ,206,138,159,-47,297,2021-03-27T00:00:00,12686,12686,5148,17834
ΣΠΟΡΑΔΩΝ,504,0,0,-96,0,2021-03-27T00:00:00,807,807,351,1158
ΣΥΡΟΥ,1212,55,52,-6,107,2021-03-27T00:00:00,2147,2147,1085,3232
ΤΗΝΟΥ,1213,54,0,0,54,2021-03-27T00:00:00,530,530,315,845
ΤΡΙΚΑΛΩΝ,505,113,219,-49,332,2021-03-27T00:00:00,12723,12723,6545,19268
ΦΘΙΩΤΙΔΑΣ,804,157,220,-4,377,2021-03-27T00:00:00,11228,11228,5552,16780
ΦΛΩΡΙΝΑΣ,304,7,161,12,168,2021-03-27T00:00:00,4875,4875,2594,7469
ΦΩΚΙΔΑΣ,805,2,52,-4,54,2021-03-27T00:00:00,2708,2708,1361,4069
ΧΑΛΚΙΔΙΚΗΣ,207,19,298,-37,317,2021-03-27T00:00:00,9250,9250,4279,13529
ΧΑΝΙΩΝ,1304,109,422,-49,531,2021-03-27T00:00:00,16614,16614,8891,25505
ΧΙΟΥ,1105,64,56,-92,120,2021-03-27T00:00:00,5074,5075,2562,7637
ΑΙΤΩΛΟΑΚΑΡΝΑΝΙΑΣ,701,294,117,-43,411,2021-03-31T00:00:00,14707,14707,5505,20212
ΑΝΑΤΟΛΙΚΗΣ ΑΤΤΙΚΗΣ,901,391,405,-48,796,2021-03-31T00:00:00,31058,31058,12826,43884
ΑΝΔΡΟΥ,1201,30,0,-21,30,2021-03-31T00:00:00,646,646,297,943
ΑΡΓΟΛΙΔΑΣ,1001,111,148,-14,259,2021-03-31T00:00:00,8725,8725,4320,13045
ΑΡΚΑΔΙΑΣ,1002,178,139,-48,317,2021-03-31T00:00:00,8863,8863,4083,12946
ΑΡΤΑΣ,401,74,96,-39,170,2021-03-31T00:00:00,6466,6466,4460,10926
ΑΧΑΪΑΣ,702,293,472,0,765,2021-03-31T00:00:00,25499,25499,14921,40420
ΒΟΙΩΤΙΑΣ,801,222,176,-30,398,2021-03-31T00:00:00,12277,12277,4755,17032
ΒΟΡΕΙΟΥ ΤΟΜΕΑ ΑΘΗΝΩΝ,902,618,3148,-158,3766,2021-03-31T00:00:00,137964,137965,88143,226108
ΓΡΕΒΕΝΩΝ,301,46,78,-1,124,2021-03-31T00:00:00,3565,3565,2081,5646
ΔΡΑΜΑΣ,101,78,171,-43,249,2021-03-31T00:00:00,8382,8382,5063,13445
ΔΥΤΙΚΗΣ ΑΤΤΙΚΗΣ,903,109,166,-79,275,2021-03-31T00:00:00,9257,9257,5065,14322
ΔΥΤΙΚΟΥ ΤΟΜΕΑ ΑΘΗΝΩΝ,904,350,891,6,1241,2021-03-31T00:00:00,44140,44140,24361,68501
ΕΒΡΟΥ,102,228,240,-30,468,2021-03-31T00:00:00,15317,15317,8653,23970
ΕΥΒΟΙΑΣ,802,247,460,-150,707,2021-03-31T00:00:00,18202,18202,10438,28640
ΕΥΡΥΤΑΝΙΑΣ,803,12,43,-1,55,2021-03-31T00:00:00,1768,1768,1058,2826
ΖΑΚΥΝΘΟΥ,601,57,84,-5,141,2021-03-31T00:00:00,3163,3163,2176,5339
ΗΛΕΙΑΣ,703,157,238,-16,395,2021-03-31T00:00:00,11483,11483,6073,17556
ΗΜΑΘΙΑΣ,201,168,133,-37,301,2021-03-31T00:00:00,12175,12175,6690,18865
ΗΡΑΚΛΕΙΟΥ,1301,355,365,-76,720,2021-03-31T00:00:00,26211,26211,14985,41196
ΘΑΣΟΥ,103,41,0,-13,41,2021-03-31T00:00:00,810,810,454,1264
ΘΕΣΠΡΩΤΙΑΣ,402,49,148,-42,197,2021-03-31T00:00:00,6412,6412,3613,10025
ΘΕΣΣΑΛΟΝΙΚΗΣ,202,1084,2485,-100,3569,2021-03-31T00:00:00,117965,117967,72324,190291
ΘΗΡΑΣ,1202,4,28,-47,32,2021-03-31T00:00:00,1223,1223,723,1946
ΙΘΑΚΗΣ,602,7,23,-18,30,2021-03-31T00:00:00,836,836,574,1410
ΙΚΑΡΙΑΣ,1101,11,28,2,39,2021-03-31T00:00:00,1503,1503,1101,2604
ΙΩΑΝΝΙΝΩΝ,403,214,204,-37,418,2021-03-31T00:00:00,18500,18501,11357,29858
ΚΑΒΑΛΑΣ,104,151,194,-28,345,2021-03-31T00:00:00,11064,11064,6507,17571
ΚΑΛΥΜΝΟΥ,1203,5,33,-28,38,2021-03-31T00:00:00,1584,1584,1441,3025
ΚΑΡΔΙΤΣΑΣ,501,264,107,-41,371,2021-03-31T00:00:00,13492,13492,5976,19468
ΚΑΡΠΑΘΟΥ,1204,17,25,18,42,2021-03-31T00:00:00,808,808,456,1264
ΚΑΣΤΟΡΙΑΣ,302,64,130,-14,194,2021-03-31T00:00:00,6357,6357,3352,9709
ΚΕΑΣ-ΚΥΘΝΟΥ,1205,5,18,-1,23,2021-03-31T00:00:00,716,716,72,788
ΚΕΝΤΡΙΚΟΥ ΤΟΜΕΑ ΑΘΗΝΩΝ,905,1162,2242,-17,3404,2021-03-31T00:00:00,151123,151124,87264,238388
ΚΕΡΚΥΡΑΣ,603,95,237,-36,332,2021-03-31T00:00:00,9347,9347,5260,14607
ΚΕΦΑΛΛΗΝΙΑΣ,604,52,111,38,163,2021-03-31T00:00:00,4231,4231,2702,6933
ΚΙΛΚΙΣ,203,67,230,-11,297,2021-03-31T00:00:00,8164,8164,5460,13624
ΚΟΖΑΝΗΣ,303,132,188,-24,320,2021-03-31T00:00:00,13617,13617,6768,20385
ΚΟΡΙΝΘΙΑΣ,1003,197,86,-29,283,2021-03-31T00:00:00,11096,11096,4240,15336
ΚΩ,1206,18,59,-22,77,2021-03-31T00:00:00,3498,3498,1993,5491
ΛΑΚΩΝΙΑΣ,1004,141,127,-22,268,2021-03-31T00:00:00,8494,8494,4402,12896
ΛΑΡΙΣΑΣ,502,451,153,-144,604,2021-03-31T00:00:00,22917,22917,10233,33150
ΛΑΣΙΘΙΟΥ,1302,86,227,-3,313,2021-03-31T00:00:00,9238,9238,6430,15668
ΛΕΣΒΟΥ,1102,56,142,0,198,2021-03-31T00:00:00,6783,6783,3773,10556
ΛΕΥΚΑΔΑΣ,605,51,51,-14,102,2021-03-31T00:00:00,3687,3687,2120,5807
ΛΗΜΝΟΥ,1103,133,42,92,175,2021-03-31T00:00:00,1905,1905,1170,3075
ΜΑΓΝΗΣΙΑΣ,503,188,282,-53,470,2021-03-31T00:00:00,15204,15204,7666,22870
ΜΕΣΣΗΝΙΑΣ,1005,218,217,-1,435,2021-03-31T00:00:00,12973,12973,7424,20397
ΜΗΛΟΥ,1207,24,0,-191,24,2021-03-31T00:00:00,1799,1799,443,2242
ΜΥΚΟΝΟΥ,1208,6,0,-6,6,2021-03-31T00:00:00,459,459,172,631
ΝΑΞΟΥ,1209,0,35,-13,35,2021-03-31T00:00:00,901,901,788,1689
ΝΗΣΩΝ,906,196,118,-202,314,2021-03-31T00:00:00,5757,5757,2875,8632
ΝΟΤΙΟΥ ΤΟΜΕΑ ΑΘΗΝΩΝ,907,416,257,-2,673,2021-03-31T00:00:00,30024,30024,12063,42087
ΞΑΝΘΗΣ,105,77,132,-46,209,2021-03-31T00:00:00,7103,7103,4271,11374
ΠΑΡΟΥ,1210,101,0,24,101,2021-03-31T00:00:00,743,743,317,1060
ΠΕΙΡΑΙΩΣ,908,368,736,-108,1104,2021-03-31T00:00:00,45004,45004,23166,68170
ΠΕΛΛΑΣ,204,39,232,-24,271,2021-03-31T00:00:00,13458,13459,7596,21055
ΠΙΕΡΙΑΣ,205,98,168,28,266,2021-03-31T00:00:00,9619,9619,5689,15308
ΠΡΕΒΕΖΑΣ,404,124,48,-23,172,2021-03-31T00:00:00,6246,6246,1782,8028
ΡΕΘΥΜΝΟΥ,1303,57,156,-48,213,2021-03-31T00:00:00,7842,7842,4533,12375
ΡΟΔΟΠΗΣ,106,125,106,4,231,2021-03-31T00:00:00,6869,6869,3625,10494
ΡΟΔΟΥ,1211,110,113,-28,223,2021-03-31T00:00:00,8488,8488,4778,13266
ΣΑΜΟΥ,1104,36,48,-14,84,2021-03-31T00:00:00,2717,2717,1298,4015
ΣΕΡΡΩΝ,206,290,148,-27,438,2021-03-31T00:00:00,13454,13454,5598,19052
ΣΠΟΡΑΔΩΝ,504,13,41,12,54,2021-03-31T00:00:00,843,843,411,1254
ΣΥΡΟΥ,1212,37,48,0,85,2021-03-31T00:00:00,2273,2273,1231,3504
ΤΗΝΟΥ,1213,36,0,-6,36,2021-03-31T00:00:00,662,662,315,977
ΤΡΙΚΑΛΩΝ,505,222,113,-28,335,2021-03-31T00:00:00,13295,13295,6953,20248
ΦΘΙΩΤΙΔΑΣ,804,151,191,-43,342,2021-03-31T00:00:00,11715,11715,6171,17886
ΦΛΩΡΙΝΑΣ,304,28,132,-71,160,2021-03-31T00:00:00,4991,4991,3019,8010
ΦΩΚΙΔΑΣ,805,42,42,-73,84,2021-03-31T00:00:00,2861,2861,1502,4363
ΧΑΛΚΙΔΙΚΗΣ,207,164,219,-28,383,2021-03-31T00:00:00,9643,9643,5014,14657
ΧΑΝΙΩΝ,1304,151,356,-70,507,2021-03-31T00:00:00,17102,17102,10029,27131
ΧΙΟΥ,1105,83,50,-18,133,2021-03-31T00:00:00,5350,5351,2720,8071
ΑΙΤΩΛΟΑΚΑΡΝΑΝΙΑΣ,701,221,84,-35,305,2021-03-29T00:00:00,14077,14077,5270,19347
ΑΝΑΤΟΛΙΚΗΣ ΑΤΤΙΚΗΣ,901,395,426,63,821,2021-03-29T00:00:00,30241,30241,12003,42244
ΑΝΔΡΟΥ,1201,54,0,6,54,2021-03-29T00:00:00,566,566,296,862
ΑΡΓΟΛΙΔΑΣ,1001,85,153,3,238,2021-03-29T00:00:00,8466,8466,4047,12513
ΑΡΚΑΔΙΑΣ,1002,104,152,21,256,2021-03-29T00:00:00,8458,8458,3806,12264
ΑΡΤΑΣ,401,57,144,34,201,2021-03-29T00:00:00,6277,6277,4270,10547
ΑΧΑΪΑΣ,702,279,505,-29,784,2021-03-29T00:00:00,24885,24885,14005,38890
ΒΟΙΩΤΙΑΣ,801,121,194,7,315,2021-03-29T00:00:00,11813,11813,4393,16206
ΒΟΡΕΙΟΥ ΤΟΜΕΑ ΑΘΗΝΩΝ,902,1492,2980,642,4472,2021-03-29T00:00:00,136493,136494,81924,218418
ΓΡΕΒΕΝΩΝ,301,25,95,-7,120,2021-03-29T00:00:00,3481,3481,1916,5397
ΔΡΑΜΑΣ,101,72,179,-3,251,2021-03-29T00:00:00,8212,8212,4692,12904
ΔΥΤΙΚΗΣ ΑΤΤΙΚΗΣ,903,54,303,-8,357,2021-03-29T00:00:00,9015,9015,4678,13693
ΔΥΤΙΚΟΥ ΤΟΜΕΑ ΑΘΗΝΩΝ,904,309,883,-89,1192,2021-03-29T00:00:00,43438,43438,22587,66025
ΕΒΡΟΥ,102,99,297,-39,396,2021-03-29T00:00:00,14888,14888,8116,23004
ΕΥΒΟΙΑΣ,802,186,478,52,664,2021-03-29T00:00:00,17654,17654,9422,27076
ΕΥΡΥΤΑΝΙΑΣ,803,9,47,-3,56,2021-03-29T00:00:00,1738,1738,977,2715
ΖΑΚΥΝΘΟΥ,601,58,97,2,155,2021-03-29T00:00:00,3056,3056,1996,5052
ΗΛΕΙΑΣ,703,128,247,3,375,2021-03-29T00:00:00,11161,11161,5589,16750
ΗΜΑΘΙΑΣ,201,61,193,-43,254,2021-03-29T00:00:00,11811,11811,6415,18226
ΗΡΑΚΛΕΙΟΥ,1301,355,437,-21,792,2021-03-29T00:00:00,25432,25432,14248,39680
ΘΑΣΟΥ,103,55,0,-5,55,2021-03-29T00:00:00,715,715,454,1169
ΘΕΣΠΡΩΤΙΑΣ,402,63,207,1,270,2021-03-29T00:00:00,6291,6291,3298,9589
ΘΕΣΣΑΛΟΝΙΚΗΣ,202,1182,2564,-126,3746,2021-03-29T00:00:00,115705,115707,67346,183053
ΘΗΡΑΣ,1202,24,51,-9,75,2021-03-29T00:00:00,1204,1204,631,1835
ΙΘΑΚΗΣ,602,2,40,0,42,2021-03-29T00:00:00,828,828,504,1332
ΙΚΑΡΙΑΣ,1101,4,28,-25,32,2021-03-29T00:00:00,1479,1479,1049,2528
ΙΩΑΝΝΙΝΩΝ,403,202,292,-23,494,2021-03-29T00:00:00,18053,18054,10931,28985
ΚΑΒΑΛΑΣ,104,118,206,-31,324,2021-03-29T00:00:00,10738,10738,6115,16853
ΚΑΛΥΜΝΟΥ,1203,5,74,8,79,2021-03-29T00:00:00,1574,1574,1347,2921
ΚΑΡΔΙΤΣΑΣ,501,91,191,-9,282,2021-03-29T00:00:00,12934,12934,5751,18685
ΚΑΡΠΑΘΟΥ,1204,132,18,78,150,2021-03-29T00:00:00,790,790,408,1198
ΚΑΣΤΟΡΙΑΣ,302,54,151,-13,205,2021-03-29T00:00:00,6223,6223,3084,9307
ΚΕΑΣ-ΚΥΘΝΟΥ,1205,3,0,-122,3,2021-03-29T00:00:00,701,701,40,741
ΚΕΝΤΡΙΚΟΥ ΤΟΜΕΑ ΑΘΗΝΩΝ,905,1325,2104,-225,3429,2021-03-29T00:00:00,148732,148733,82830,231563
ΚΕΡΚΥΡΑΣ,603,72,215,-44,287,2021-03-29T00:00:00,9133,9133,4774,13907
ΚΕΦΑΛΛΗΝΙΑΣ,604,1,145,14,146,2021-03-29T00:00:00,4171,4171,2474,6645
ΚΙΛΚΙΣ,203,21,282,7,303,2021-03-29T00:00:00,8027,8027,4992,13019
ΚΟΖΑΝΗΣ,303,122,201,-67,323,2021-03-29T00:00:00,13331,13331,6390,19721
ΚΟΡΙΝΘΙΑΣ,1003,162,103,-20,265,2021-03-29T00:00:00,10669,10669,4072,14741
ΚΩ,1206,44,76,-4,120,2021-03-29T00:00:00,3456,3456,1859,5315
ΛΑΚΩΝΙΑΣ,1004,47,141,-3,188,2021-03-29T00:00:00,8198,8198,4140,12338
ΛΑΡΙΣΑΣ,502,236,167,-51,403,2021-03-29T00:00:00,21862,21862,9936,31798
ΛΑΣΙΘΙΟΥ,1302,50,291,-22,341,2021-03-29T00:00:00,9043,9043,5996,15039
ΛΕΣΒΟΥ,1102,58,157,9,215,2021-03-29T00:00:00,6672,6672,3488,10160
ΛΕΥΚΑΔΑΣ,605,4,60,-1,64,2021-03-29T00:00:00,3574,3574,2015,5589
ΛΗΜΝΟΥ,1103,30,53,-4,83,2021-03-29T00:00:00,1739,1739,1078,2817
ΜΑΓΝΗΣΙΑΣ,503,176,301,39,477,2021-03-29T00:00:00,14777,14777,7100,21877
ΜΕΣΣΗΝΙΑΣ,1005,88,255,-4,343,2021-03-29T00:00:00,12543,12543,6983,19526
ΜΗΛΟΥ,1207,72,55,79,127,2021-03-29T00:00:00,1596,1596,407,2003
ΜΥΚΟΝΟΥ,1208,48,0,-6,48,2021-03-29T00:00:00,441,441,172,613
ΝΑΞΟΥ,1209,3,45,-6,48,2021-03-29T00:00:00,901,901,705,1606
ΝΗΣΩΝ,906,201,189,166,390,2021-03-29T00:00:00,5263,5263,2539,7802
ΝΟΤΙΟΥ ΤΟΜΕΑ ΑΘΗΝΩΝ,907,492,253,5,745,2021-03-29T00:00:00,29187,29187,11552,40739
ΞΑΝΘΗΣ,105,49,168,-5,217,2021-03-29T00:00:00,6930,6930,3980,10910
ΠΑΡΟΥ,1210,47,1,0,48,2021-03-29T00:00:00,565,565,317,882
ΠΕΙΡΑΙΩΣ,908,346,799,-186,1145,2021-03-29T00:00:00,44209,44209,21645,65854
ΠΕΛΛΑΣ,204,50,247,13,297,2021-03-29T00:00:00,13360,13361,7128,20489
ΠΙΕΡΙΑΣ,205,101,165,-46,266,2021-03-29T00:00:00,9437,9437,5367,14804
ΠΡΕΒΕΖΑΣ,404,81,52,-6,133,2021-03-29T00:00:00,5979,5979,1682,7661
ΡΕΘΥΜΝΟΥ,1303,45,206,19,251,2021-03-29T00:00:00,7694,7694,4207,11901
ΡΟΔΟΠΗΣ,106,79,118,19,197,2021-03-29T00:00:00,6619,6619,3417,10036
ΡΟΔΟΥ,1211,136,160,-34,296,2021-03-29T00:00:00,8267,8267,4525,12792
ΣΑΜΟΥ,1104,15,52,6,67,2021-03-29T00:00:00,2629,2629,1204,3833
ΣΕΡΡΩΝ,206,160,155,18,315,2021-03-29T00:00:00,12846,12846,5303,18149
ΣΠΟΡΑΔΩΝ,504,0,0,0,0,2021-03-29T00:00:00,807,807,351,1158
ΣΥΡΟΥ,1212,52,50,-5,102,2021-03-29T00:00:00,2199,2199,1135,3334
ΤΗΝΟΥ,1213,54,0,0,54,2021-03-29T00:00:00,584,584,315,899
ΤΡΙΚΑΛΩΝ,505,107,175,-50,282,2021-03-29T00:00:00,12830,12830,6720,19550
ΦΘΙΩΤΙΔΑΣ,804,160,219,2,379,2021-03-29T00:00:00,11388,11388,5771,17159
ΦΛΩΡΙΝΑΣ,304,22,128,-18,150,2021-03-29T00:00:00,4897,4897,2722,7619
ΦΩΚΙΔΑΣ,805,2,51,-1,53,2021-03-29T00:00:00,2710,2710,1412,4122
ΧΑΛΚΙΔΙΚΗΣ,207,54,280,17,334,2021-03-29T00:00:00,9304,9304,4559,13863
ΧΑΝΙΩΝ,1304,129,413,11,542,2021-03-29T00:00:00,16743,16743,9304,26047
ΧΙΟΥ,1105,90,60,30,150,2021-03-29T00:00:00,5164,5165,2622,7787
ΑΙΤΩΛΟΑΚΑΡΝΑΝΙΑΣ,701,336,118,149,454,2021-03-30T00:00:00,14413,14413,5388,19801
ΑΝΑΤΟΛΙΚΗΣ ΑΤΤΙΚΗΣ,901,426,418,23,844,2021-03-30T00:00:00,30667,30667,12421,43088
ΑΝΔΡΟΥ,1201,50,1,-3,51,2021-03-30T00:00:00,616,616,297,913
ΑΡΓΟΛΙΔΑΣ,1001,148,125,35,273,2021-03-30T00:00:00,8614,8614,4172,12786
ΑΡΚΑΔΙΑΣ,1002,227,138,109,365,2021-03-30T00:00:00,8685,8685,3944,12629
ΑΡΤΑΣ,401,115,94,8,209,2021-03-30T00:00:00,6392,6392,4364,10756
ΑΧΑΪΑΣ,702,321,444,-19,765,2021-03-30T00:00:00,25206,25206,14449,39655
ΒΟΙΩΤΙΑΣ,801,242,186,113,428,2021-03-30T00:00:00,12055,12055,4579,16634
ΒΟΡΕΙΟΥ ΤΟΜΕΑ ΑΘΗΝΩΝ,902,853,3071,-548,3924,2021-03-30T00:00:00,137346,137347,84995,222342
ΓΡΕΒΕΝΩΝ,301,38,87,5,125,2021-03-30T00:00:00,3519,3519,2003,5522
ΔΡΑΜΑΣ,101,92,200,41,292,2021-03-30T00:00:00,8304,8304,4892,13196
ΔΥΤΙΚΗΣ ΑΤΤΙΚΗΣ,903,133,221,-3,354,2021-03-30T00:00:00,9148,9148,4899,14047
ΔΥΤΙΚΟΥ ΤΟΜΕΑ ΑΘΗΝΩΝ,904,352,883,43,1235,2021-03-30T00:00:00,43790,43790,23470,67260
ΕΒΡΟΥ,102,201,297,102,498,2021-03-30T00:00:00,15089,15089,8413,23502
ΕΥΒΟΙΑΣ,802,301,556,193,857,2021-03-30T00:00:00,17955,17955,9978,27933
ΕΥΡΥΤΑΝΙΑΣ,803,18,38,0,56,2021-03-30T00:00:00,1756,1756,1015,2771
ΖΑΚΥΝΘΟΥ,601,50,96,-9,146,2021-03-30T00:00:00,3106,3106,2092,5198
ΗΛΕΙΑΣ,703,165,246,36,411,2021-03-30T00:00:00,11326,11326,5835,17161
ΗΜΑΘΙΑΣ,201,196,142,84,338,2021-03-30T00:00:00,12007,12007,6557,18564
ΗΡΑΚΛΕΙΟΥ,1301,424,372,4,796,2021-03-30T00:00:00,25856,25856,14620,40476
ΘΑΣΟΥ,103,54,0,-1,54,2021-03-30T00:00:00,769,769,454,1223
ΘΕΣΠΡΩΤΙΑΣ,402,72,167,-31,239,2021-03-30T00:00:00,6363,6363,3465,9828
ΘΕΣΣΑΛΟΝΙΚΗΣ,202,1176,2493,-77,3669,2021-03-30T00:00:00,116881,116883,69839,186722
ΘΗΡΑΣ,1202,15,64,4,79,2021-03-30T00:00:00,1219,1219,695,1914
ΙΘΑΚΗΣ,602,1,47,6,48,2021-03-30T00:00:00,829,829,551,1380
ΙΚΑΡΙΑΣ,1101,13,24,5,37,2021-03-30T00:00:00,1492,1492,1073,2565
ΙΩΑΝΝΙΝΩΝ,403,233,222,-39,455,2021-03-30T00:00:00,18286,18287,11153,29440
ΚΑΒΑΛΑΣ,104,175,198,49,373,2021-03-30T00:00:00,10913,10913,6313,17226
ΚΑΛΥΜΝΟΥ,1203,5,61,-13,66,2021-03-30T00:00:00,1579,1579,1408,2987
ΚΑΡΔΙΤΣΑΣ,501,294,118,130,412,2021-03-30T00:00:00,13228,13228,5869,19097
ΚΑΡΠΑΘΟΥ,1204,1,23,-126,24,2021-03-30T00:00:00,791,791,431,1222
ΚΑΣΤΟΡΙΑΣ,302,70,138,3,208,2021-03-30T00:00:00,6293,6293,3222,9515
ΚΕΑΣ-ΚΥΘΝΟΥ,1205,10,14,21,24,2021-03-30T00:00:00,711,711,54,765
ΚΕΝΤΡΙΚΟΥ ΤΟΜΕΑ ΑΘΗΝΩΝ,905,1229,2192,-8,3421,2021-03-30T00:00:00,149961,149962,85022,234984
ΚΕΡΚΥΡΑΣ,603,119,249,81,368,2021-03-30T00:00:00,9252,9252,5023,14275
ΚΕΦΑΛΛΗΝΙΑΣ,604,8,117,-21,125,2021-03-30T00:00:00,4179,4179,2591,6770
ΚΙΛΚΙΣ,203,70,238,5,308,2021-03-30T00:00:00,8097,8097,5230,13327
ΚΟΖΑΝΗΣ,303,154,190,21,344,2021-03-30T00:00:00,13485,13485,6580,20065
ΚΟΡΙΝΘΙΑΣ,1003,230,82,47,312,2021-03-30T00:00:00,10899,10899,4154,15053
ΚΩ,1206,24,75,-21,99,2021-03-30T00:00:00,3480,3480,1934,5414
ΛΑΚΩΝΙΑΣ,1004,155,135,102,290,2021-03-30T00:00:00,8353,8353,4275,12628
ΛΑΡΙΣΑΣ,502,604,144,345,748,2021-03-30T00:00:00,22466,22466,10080,32546
ΛΑΣΙΘΙΟΥ,1302,109,207,-25,316,2021-03-30T00:00:00,9152,9152,6203,15355
ΛΕΣΒΟΥ,1102,55,143,-17,198,2021-03-30T00:00:00,6727,6727,3631,10358
ΛΕΥΚΑΔΑΣ,605,62,54,52,116,2021-03-30T00:00:00,3636,3636,2069,5705
ΛΗΜΝΟΥ,1103,33,50,0,83,2021-03-30T00:00:00,1772,1772,1128,2900
ΜΑΓΝΗΣΙΑΣ,503,239,284,46,523,2021-03-30T00:00:00,15016,15016,7384,22400
ΜΕΣΣΗΝΙΑΣ,1005,212,224,93,436,2021-03-30T00:00:00,12755,12755,7207,19962
ΜΗΛΟΥ,1207,179,36,88,215,2021-03-30T00:00:00,1775,1775,443,2218
ΜΥΚΟΝΟΥ,1208,12,0,-36,12,2021-03-30T00:00:00,453,453,172,625
ΝΑΞΟΥ,1209,0,48,0,48,2021-03-30T00:00:00,901,901,753,1654
ΝΗΣΩΝ,906,298,218,126,516,2021-03-30T00:00:00,5561,5561,2757,8318
ΝΟΤΙΟΥ ΤΟΜΕΑ ΑΘΗΝΩΝ,907,421,254,-70,675,2021-03-30T00:00:00,29608,29608,11806,41414
ΞΑΝΘΗΣ,105,96,159,38,255,2021-03-30T00:00:00,7026,7026,4139,11165
ΠΑΡΟΥ,1210,77,0,29,77,2021-03-30T00:00:00,642,642,317,959
ΠΕΙΡΑΙΩΣ,908,427,785,67,1212,2021-03-30T00:00:00,44636,44636,22430,67066
ΠΕΛΛΑΣ,204,59,236,-2,295,2021-03-30T00:00:00,13419,13420,7364,20784
ΠΙΕΡΙΑΣ,205,84,154,-28,238,2021-03-30T00:00:00,9521,9521,5521,15042
ΠΡΕΒΕΖΑΣ,404,143,52,62,195,2021-03-30T00:00:00,6122,6122,1734,7856
ΡΕΘΥΜΝΟΥ,1303,91,170,10,261,2021-03-30T00:00:00,7785,7785,4377,12162
ΡΟΔΟΠΗΣ,106,125,102,30,227,2021-03-30T00:00:00,6744,6744,3519,10263
ΡΟΔΟΥ,1211,111,140,-45,251,2021-03-30T00:00:00,8378,8378,4665,13043
ΣΑΜΟΥ,1104,52,46,31,98,2021-03-30T00:00:00,2681,2681,1250,3931
ΣΕΡΡΩΝ,206,318,147,150,465,2021-03-30T00:00:00,13164,13164,5450,18614
ΣΠΟΡΑΔΩΝ,504,23,19,42,42,2021-03-30T00:00:00,830,830,370,1200
ΣΥΡΟΥ,1212,37,48,-17,85,2021-03-30T00:00:00,2236,2236,1183,3419
ΤΗΝΟΥ,1213,42,0,-12,42,2021-03-30T00:00:00,626,626,315,941
ΤΡΙΚΑΛΩΝ,505,243,120,81,363,2021-03-30T00:00:00,13073,13073,6840,19913
ΦΘΙΩΤΙΔΑΣ,804,176,209,6,385,2021-03-30T00:00:00,11564,11564,5980,17544
ΦΛΩΡΙΝΑΣ,304,66,165,81,231,2021-03-30T00:00:00,4963,4963,2887,7850
ΦΩΚΙΔΑΣ,805,109,48,104,157,2021-03-30T00:00:00,2819,2819,1460,4279
ΧΑΛΚΙΔΙΚΗΣ,207,175,236,77,411,2021-03-30T00:00:00,9479,9479,4795,14274
ΧΑΝΙΩΝ,1304,208,369,35,577,2021-03-30T00:00:00,16951,16951,9673,26624
ΧΙΟΥ,1105,103,48,1,151,2021-03-30T00:00:00,5267,5268,2670,7938
ΑΙΤΩΛΟΑΚΑΡΝΑΝΙΑΣ,701,188,41,13,229,2021-02-04T00:00:00,2691,2691,728,3419
ΑΝΑΤΟΛΙΚΗΣ ΑΤΤΙΚΗΣ,901,531,2,23,533,2021-02-04T00:00:00,6773,6773,619,7392
ΑΝΔΡΟΥ,1201,13,0,-22,13,2021-02-04T00:00:00,252,252,0,252
ΑΡΓΟΛΙΔΑΣ,1001,167,0,0,167,2021-02-04T00:00:00,2411,2411,260,2671
ΑΡΚΑΔΙΑΣ,1002,160,1,0,161,2021-02-04T00:00:00,2315,2315,484,2799
ΑΡΤΑΣ,401,152,10,-25,162,2021-02-04T00:00:00,2392,2392,552,2944
ΑΧΑΪΑΣ,702,504,66,10,570,2021-02-04T00:00:00,8301,8301,1997,10298
ΒΟΙΩΤΙΑΣ,801,115,1,-5,116,2021-02-04T00:00:00,2226,2226,352,2578
ΒΟΡΕΙΟΥ ΤΟΜΕΑ ΑΘΗΝΩΝ,902,1624,1749,104,3373,2021-02-04T00:00:00,36209,36209,9757,45966
ΓΡΕΒΕΝΩΝ,301,54,0,0,54,2021-02-04T00:00:00,792,792,193,985
ΔΡΑΜΑΣ,101,153,1,4,154,2021-02-04T00:00:00,2328,2328,371,2699
ΔΥΤΙΚΗΣ ΑΤΤΙΚΗΣ,903,60,18,-19,78,2021-02-04T00:00:00,2856,2856,518,3374
ΔΥΤΙΚΟΥ ΤΟΜΕΑ ΑΘΗΝΩΝ,904,587,155,52,742,2021-02-04T00:00:00,11637,11637,2525,14162
ΕΒΡΟΥ,102,170,130,-6,300,2021-02-04T00:00:00,4263,4263,956,5219
ΕΥΒΟΙΑΣ,802,249,2,-52,251,2021-02-04T00:00:00,5115,5115,567,5682
ΕΥΡΥΤΑΝΙΑΣ,803,29,1,-12,30,2021-02-04T00:00:00,565,565,144,709
ΖΑΚΥΝΘΟΥ,601,14,40,0,54,2021-02-04T00:00:00,1168,1168,137,1305
ΗΛΕΙΑΣ,703,210,1,-7,211,2021-02-04T00:00:00,3197,3197,504,3701
ΗΜΑΘΙΑΣ,201,202,14,0,216,2021-02-04T00:00:00,2992,2992,594,3586
ΗΡΑΚΛΕΙΟΥ,1301,270,292,35,562,2021-02-04T00:00:00,8246,8246,1930,10176
ΘΑΣΟΥ,103,38,4,-6,42,2021-02-04T00:00:00,304,304,13,317
ΘΕΣΠΡΩΤΙΑΣ,402,108,0,-4,108,2021-02-04T00:00:00,1648,1648,221,1869
ΘΕΣΣΑΛΟΝΙΚΗΣ,202,1628,949,-189,2577,2021-02-04T00:00:00,31707,31707,9044,40751
ΘΗΡΑΣ,1202,6,0,-6,6,2021-02-04T00:00:00,304,304,19,323
ΙΘΑΚΗΣ,602,0,0,0,0,2021-02-04T00:00:00,0,0,0,0
ΙΚΑΡΙΑΣ,1101,6,0,-24,6,2021-02-04T00:00:00,357,357,30,387
ΙΩΑΝΝΙΝΩΝ,403,238,137,-74,375,2021-02-04T00:00:00,6278,6278,2397,8675
ΚΑΒΑΛΑΣ,104,205,11,-30,216,2021-02-04T00:00:00,3114,3114,567,3681
ΚΑΛΥΜΝΟΥ,1203,0,30,-64,30,2021-02-04T00:00:00,664,664,127,791
ΚΑΡΔΙΤΣΑΣ,501,219,2,-25,221,2021-02-04T00:00:00,3411,3411,537,3948
ΚΑΡΠΑΘΟΥ,1204,6,0,-12,6,2021-02-04T00:00:00,252,252,15,267
ΚΑΣΤΟΡΙΑΣ,302,66,35,-5,101,2021-02-04T00:00:00,1448,1448,282,1730
ΚΕΑΣ-ΚΥΘΝΟΥ,1205,0,0,0,0,2021-02-04T00:00:00,0,0,0,0
ΚΕΝΤΡΙΚΟΥ ΤΟΜΕΑ ΑΘΗΝΩΝ,905,2519,1250,-73,3769,2021-02-04T00:00:00,45025,45025,16459,61484
ΚΕΡΚΥΡΑΣ,603,73,0,-76,73,2021-02-04T00:00:00,2578,2578,196,2774
ΚΕΦΑΛΛΗΝΙΑΣ,604,54,0,-29,54,2021-02-04T00:00:00,1583,1583,173,1756
ΚΙΛΚΙΣ,203,114,0,-36,114,2021-02-04T00:00:00,2259,2259,304,2563
ΚΟΖΑΝΗΣ,303,207,21,24,228,2021-02-04T00:00:00,2965,2965,662,3627
ΚΟΡΙΝΘΙΑΣ,1003,162,0,0,162,2021-02-04T00:00:00,2122,2122,296,2418
ΚΩ,1206,7,40,-2,47,2021-02-04T00:00:00,915,915,86,1001
ΛΑΚΩΝΙΑΣ,1004,153,2,30,155,2021-02-04T00:00:00,2411,2411,367,2778
ΛΑΡΙΣΑΣ,502,367,5,-19,372,2021-02-04T00:00:00,5875,5875,1695,7570
ΛΑΣΙΘΙΟΥ,1302,136,49,-12,185,2021-02-04T00:00:00,3623,3623,499,4122
ΛΕΣΒΟΥ,1102,75,57,-24,132,2021-02-04T00:00:00,2258,2258,208,2466
ΛΕΥΚΑΔΑΣ,605,48,6,0,54,2021-02-04T00:00:00,851,851,100,951
ΛΗΜΝΟΥ,1103,4,50,-12,54,2021-02-04T00:00:00,653,653,155,808
ΜΑΓΝΗΣΙΑΣ,503,150,90,-19,240,2021-02-04T00:00:00,3377,3377,516,3893
ΜΕΣΣΗΝΙΑΣ,1005,262,10,20,272,2021-02-04T00:00:00,3848,3848,561,4409
ΜΗΛΟΥ,1207,23,0,1,23,2021-02-04T00:00:00,124,124,0,124
ΜΥΚΟΝΟΥ,1208,0,0,0,0,2021-02-04T00:00:00,144,144,0,144
ΝΑΞΟΥ,1209,9,9,-6,18,2021-02-04T00:00:00,419,419,43,462
ΝΗΣΩΝ,906,105,0,-16,105,2021-02-04T00:00:00,1320,1320,25,1345
ΝΟΤΙΟΥ ΤΟΜΕΑ ΑΘΗΝΩΝ,907,294,340,58,634,2021-02-04T00:00:00,5565,5565,733,6298
ΞΑΝΘΗΣ,105,115,5,-24,120,2021-02-04T00:00:00,1910,1910,498,2408
ΠΑΡΟΥ,1210,30,0,0,30,2021-02-04T00:00:00,258,258,0,258
ΠΕΙΡΑΙΩΣ,908,605,296,-53,901,2021-02-04T00:00:00,11303,11303,2417,13720
ΠΕΛΛΑΣ,204,307,0,2,307,2021-02-04T00:00:00,3682,3682,522,4204
ΠΙΕΡΙΑΣ,205,199,10,0,209,2021-02-04T00:00:00,2687,2687,389,3076
ΠΡΕΒΕΖΑΣ,404,53,0,-1,53,2021-02-04T00:00:00,959,959,318,1277
ΡΕΘΥΜΝΟΥ,1303,19,83,-48,102,2021-02-04T00:00:00,2206,2206,365,2571
ΡΟΔΟΠΗΣ,106,76,20,-24,96,2021-02-04T00:00:00,1510,1510,281,1791
ΡΟΔΟΥ,1211,4,116,-100,120,2021-02-04T00:00:00,1983,1983,325,2308
ΣΑΜΟΥ,1104,4,44,-6,48,2021-02-04T00:00:00,755,755,157,912
ΣΕΡΡΩΝ,206,117,57,-43,174,2021-02-04T00:00:00,2335,2335,595,2930
ΣΠΟΡΑΔΩΝ,504,0,0,-6,0,2021-02-04T00:00:00,201,201,3,204
ΣΥΡΟΥ,1212,3,51,0,54,2021-02-04T00:00:00,700,700,147,847
ΤΗΝΟΥ,1213,18,0,-12,18,2021-02-04T00:00:00,262,262,1,263
ΤΡΙΚΑΛΩΝ,505,221,1,7,222,2021-02-04T00:00:00,3301,3301,634,3935
ΦΘΙΩΤΙΔΑΣ,804,28,104,-7,132,2021-02-04T00:00:00,2767,2767,624,3391
ΦΛΩΡΙΝΑΣ,304,101,0,-1,101,2021-02-04T00:00:00,1411,1411,242,1653
ΦΩΚΙΔΑΣ,805,54,1,3,55,2021-02-04T00:00:00,811,811,104,915
ΧΑΛΚΙΔΙΚΗΣ,207,90,0,-28,90,2021-02-04T00:00:00,1745,1745,249,1994
ΧΑΝΙΩΝ,1304,336,6,-21,342,2021-02-04T00:00:00,5392,5392,922,6314
ΧΙΟΥ,1105,42,30,6,72,2021-02-04T00:00:00,950,950,153,1103
ΑΙΤΩΛΟΑΚΑΡΝΑΝΙΑΣ,701,189,45,5,234,2021-02-05T00:00:00,2880,2880,773,3653
ΑΝΑΤΟΛΙΚΗΣ ΑΤΤΙΚΗΣ,901,526,2,-5,528,2021-02-05T00:00:00,7299,7299,621,7920
ΑΝΔΡΟΥ,1201,5,1,-7,6,2021-02-05T00:00:00,257,257,1,258
ΑΡΓΟΛΙΔΑΣ,1001,161,0,-6,161,2021-02-05T00:00:00,2572,2572,260,2832
ΑΡΚΑΔΙΑΣ,1002,142,2,-17,144,2021-02-05T00:00:00,2457,2457,486,2943
ΑΡΤΑΣ,401,148,2,-12,150,2021-02-05T00:00:00,2540,2540,554,3094
ΑΧΑΪΑΣ,702,445,68,-57,513,2021-02-05T00:00:00,8746,8746,2065,10811
ΒΟΙΩΤΙΑΣ,801,103,0,-13,103,2021-02-05T00:00:00,2329,2329,352,2681
ΒΟΡΕΙΟΥ ΤΟΜΕΑ ΑΘΗΝΩΝ,902,1503,1790,-80,3293,2021-02-05T00:00:00,37712,37712,11547,49259
ΓΡΕΒΕΝΩΝ,301,54,0,0,54,2021-02-05T00:00:00,846,846,193,1039
ΔΡΑΜΑΣ,101,156,0,2,156,2021-02-05T00:00:00,2484,2484,371,2855
ΔΥΤΙΚΗΣ ΑΤΤΙΚΗΣ,903,39,21,-18,60,2021-02-05T00:00:00,2895,2895,539,3434
ΔΥΤΙΚΟΥ ΤΟΜΕΑ ΑΘΗΝΩΝ,904,588,121,-33,709,2021-02-05T00:00:00,12225,12225,2646,14871
ΕΒΡΟΥ,102,172,121,-7,293,2021-02-05T00:00:00,4435,4435,1077,5512
ΕΥΒΟΙΑΣ,802,214,0,-37,214,2021-02-05T00:00:00,5329,5329,567,5896
ΕΥΡΥΤΑΝΙΑΣ,803,30,0,0,30,2021-02-05T00:00:00,595,595,144,739
ΖΑΚΥΝΘΟΥ,601,59,2,7,61,2021-02-05T00:00:00,1227,1227,139,1366
ΗΛΕΙΑΣ,703,166,1,-44,167,2021-02-05T00:00:00,3363,3363,505,3868
ΗΜΑΘΙΑΣ,201,235,15,34,250,2021-02-05T00:00:00,3227,3227,609,3836
ΗΡΑΚΛΕΙΟΥ,1301,283,250,-29,533,2021-02-05T00:00:00,8529,8529,2180,10709
ΘΑΣΟΥ,103,30,0,-12,30,2021-02-05T00:00:00,334,334,13,347
ΘΕΣΠΡΩΤΙΑΣ,402,102,0,-6,102,2021-02-05T00:00:00,1750,1750,221,1971
ΘΕΣΣΑΛΟΝΙΚΗΣ,202,1603,869,-105,2472,2021-02-05T00:00:00,33310,33310,9913,43223
ΘΗΡΑΣ,1202,5,1,0,6,2021-02-05T00:00:00,309,309,20,329
ΙΘΑΚΗΣ,602,0,0,0,0,2021-02-05T00:00:00,0,0,0,0
ΙΚΑΡΙΑΣ,1101,156,0,150,156,2021-02-05T00:00:00,513,513,30,543
ΙΩΑΝΝΙΝΩΝ,403,263,114,2,377,2021-02-05T00:00:00,6541,6541,2511,9052
ΚΑΒΑΛΑΣ,104,204,1,-11,205,2021-02-05T00:00:00,3318,3318,568,3886
ΚΑΛΥΜΝΟΥ,1203,12,0,-18,12,2021-02-05T00:00:00,676,676,127,803
ΚΑΡΔΙΤΣΑΣ,501,168,0,-53,168,2021-02-05T00:00:00,3579,3579,537,4116
ΚΑΡΠΑΘΟΥ,1204,0,0,-6,0,2021-02-05T00:00:00,252,252,15,267
ΚΑΣΤΟΡΙΑΣ,302,108,0,7,108,2021-02-05T00:00:00,1556,1556,282,1838
ΚΕΑΣ-ΚΥΘΝΟΥ,1205,0,0,0,0,2021-02-05T00:00:00,0,0,0,0
ΚΕΝΤΡΙΚΟΥ ΤΟΜΕΑ ΑΘΗΝΩΝ,905,2492,787,-490,3279,2021-02-05T00:00:00,47517,47517,17246,64763
ΚΕΡΚΥΡΑΣ,603,131,0,58,131,2021-02-05T00:00:00,2709,2709,196,2905
ΚΕΦΑΛΛΗΝΙΑΣ,604,26,0,-28,26,2021-02-05T00:00:00,1609,1609,173,1782
ΚΙΛΚΙΣ,203,84,0,-30,84,2021-02-05T00:00:00,2343,2343,304,2647
ΚΟΖΑΝΗΣ,303,191,37,0,228,2021-02-05T00:00:00,3156,3156,699,3855
ΚΟΡΙΝΘΙΑΣ,1003,154,2,-6,156,2021-02-05T00:00:00,2276,2276,298,2574
ΚΩ,1206,4,2,-41,6,2021-02-05T00:00:00,919,919,88,1007
ΛΑΚΩΝΙΑΣ,1004,157,1,3,158,2021-02-05T00:00:00,2568,2568,368,2936
ΛΑΡΙΣΑΣ,502,349,11,-12,360,2021-02-05T00:00:00,6224,6224,1706,7930
ΛΑΣΙΘΙΟΥ,1302,114,16,-55,130,2021-02-05T00:00:00,3737,3737,515,4252
ΛΕΣΒΟΥ,1102,118,1,-13,119,2021-02-05T00:00:00,2376,2376,209,2585
ΛΕΥΚΑΔΑΣ,605,54,0,0,54,2021-02-05T00:00:00,905,905,100,1005
ΛΗΜΝΟΥ,1103,41,1,-12,42,2021-02-05T00:00:00,694,694,156,850
ΜΑΓΝΗΣΙΑΣ,503,177,70,7,247,2021-02-05T00:00:00,3554,3554,586,4140
ΜΕΣΣΗΝΙΑΣ,1005,257,2,-13,259,2021-02-05T00:00:00,4105,4105,563,4668
ΜΗΛΟΥ,1207,23,2,2,25,2021-02-05T00:00:00,147,147,2,149
ΜΥΚΟΝΟΥ,1208,0,0,0,0,2021-02-05T00:00:00,144,144,0,144
ΝΑΞΟΥ,1209,6,0,-12,6,2021-02-05T00:00:00,425,425,43,468
ΝΗΣΩΝ,906,96,0,-9,96,2021-02-05T00:00:00,1416,1416,25,1441
ΝΟΤΙΟΥ ΤΟΜΕΑ ΑΘΗΝΩΝ,907,301,287,-46,588,2021-02-05T00:00:00,5866,5866,1020,6886
ΞΑΝΘΗΣ,105,95,6,-19,101,2021-02-05T00:00:00,2005,2005,504,2509
ΠΑΡΟΥ,1210,10,2,-18,12,2021-02-05T00:00:00,268,268,2,270
ΠΕΙΡΑΙΩΣ,908,687,248,34,935,2021-02-05T00:00:00,11990,11990,2665,14655
ΠΕΛΛΑΣ,204,288,1,-18,289,2021-02-05T00:00:00,3970,3970,523,4493
ΠΙΕΡΙΑΣ,205,202,10,3,212,2021-02-05T00:00:00,2889,2889,399,3288
ΠΡΕΒΕΖΑΣ,404,53,0,0,53,2021-02-05T00:00:00,1012,1012,318,1330
ΡΕΘΥΜΝΟΥ,1303,38,76,12,114,2021-02-05T00:00:00,2244,2244,441,2685
ΡΟΔΟΠΗΣ,106,70,8,-18,78,2021-02-05T00:00:00,1580,1580,289,1869
ΡΟΔΟΥ,1211,11,96,-13,107,2021-02-05T00:00:00,1994,1994,421,2415
ΣΑΜΟΥ,1104,24,30,6,54,2021-02-05T00:00:00,779,779,187,966
ΣΕΡΡΩΝ,206,148,8,-18,156,2021-02-05T00:00:00,2483,2483,603,3086
ΣΠΟΡΑΔΩΝ,504,0,0,0,0,2021-02-05T00:00:00,201,201,3,204
ΣΥΡΟΥ,1212,33,15,-6,48,2021-02-05T00:00:00,733,733,162,895
ΤΗΝΟΥ,1213,6,0,-12,6,2021-02-05T00:00:00,268,268,1,269
ΤΡΙΚΑΛΩΝ,505,204,0,-18,204,2021-02-05T00:00:00,3505,3505,634,4139
ΦΘΙΩΤΙΔΑΣ,804,97,41,6,138,2021-02-05T00:00:00,2864,2864,665,3529
ΦΛΩΡΙΝΑΣ,304,77,0,-24,77,2021-02-05T00:00:00,1488,1488,242,1730
ΦΩΚΙΔΑΣ,805,48,0,-7,48,2021-02-05T00:00:00,859,859,104,963
ΧΑΛΚΙΔΙΚΗΣ,207,77,0,-13,77,2021-02-05T00:00:00,1822,1822,249,2071
ΧΑΝΙΩΝ,1304,329,2,-11,331,2021-02-05T00:00:00,5721,5721,924,6645
ΧΙΟΥ,1105,41,43,12,84,2021-02-05T00:00:00,991,991,196,1187
ΑΙΤΩΛΟΑΚΑΡΝΑΝΙΑΣ,701,148,68,-18,216,2021-02-06T00:00:00,3028,3028,841,3869
ΑΝΑΤΟΛΙΚΗΣ ΑΤΤΙΚΗΣ,901,505,19,-4,524,2021-02-06T00:00:00,7804,7804,640,8444
ΑΝΔΡΟΥ,1201,6,0,0,6,2021-02-06T00:00:00,263,263,1,264
ΑΡΓΟΛΙΔΑΣ,1001,85,65,-11,150,2021-02-06T00:00:00,2657,2657,325,2982
ΑΡΚΑΔΙΑΣ,1002,114,31,1,145,2021-02-06T00:00:00,2571,2571,517,3088
ΑΡΤΑΣ,401,125,25,0,150,2021-02-06T00:00:00,2665,2665,579,3244
ΑΧΑΪΑΣ,702,314,116,-83,430,2021-02-06T00:00:00,9060,9060,2181,11241
ΒΟΙΩΤΙΑΣ,801,101,17,15,118,2021-02-06T00:00:00,2430,2430,369,2799
ΒΟΡΕΙΟΥ ΤΟΜΕΑ ΑΘΗΝΩΝ,902,924,1097,-1272,2021,2021-02-06T00:00:00,38636,38636,12644,51280
ΓΡΕΒΕΝΩΝ,301,28,20,-6,48,2021-02-06T00:00:00,874,874,213,1087
ΔΡΑΜΑΣ,101,96,48,-12,144,2021-02-06T00:00:00,2580,2580,419,2999
ΔΥΤΙΚΗΣ ΑΤΤΙΚΗΣ,903,34,14,-12,48,2021-02-06T00:00:00,2929,2929,553,3482
ΔΥΤΙΚΟΥ ΤΟΜΕΑ ΑΘΗΝΩΝ,904,668,124,83,792,2021-02-06T00:00:00,12893,12893,2770,15663
ΕΒΡΟΥ,102,153,105,-35,258,2021-02-06T00:00:00,4588,4588,1182,5770
ΕΥΒΟΙΑΣ,802,147,49,-18,196,2021-02-06T00:00:00,5476,5476,616,6092
ΕΥΡΥΤΑΝΙΑΣ,803,21,15,6,36,2021-02-06T00:00:00,616,616,159,775
ΖΑΚΥΝΘΟΥ,601,25,29,-7,54,2021-02-06T00:00:00,1252,1252,168,1420
ΗΛΕΙΑΣ,703,97,49,-21,146,2021-02-06T00:00:00,3460,3460,554,4014
ΗΜΑΘΙΑΣ,201,185,37,-28,222,2021-02-06T00:00:00,3412,3412,646,4058
ΗΡΑΚΛΕΙΟΥ,1301,174,334,-25,508,2021-02-06T00:00:00,8703,8703,2514,11217
ΘΑΣΟΥ,103,30,0,0,30,2021-02-06T00:00:00,364,364,13,377
ΘΕΣΠΡΩΤΙΑΣ,402,52,50,0,102,2021-02-06T00:00:00,1802,1802,271,2073
ΘΕΣΣΑΛΟΝΙΚΗΣ,202,1318,695,-459,2013,2021-02-06T00:00:00,34628,34628,10608,45236
ΘΗΡΑΣ,1202,2,10,6,12,2021-02-06T00:00:00,311,311,30,341
ΙΘΑΚΗΣ,602,0,0,0,0,2021-02-06T00:00:00,0,0,0,0
ΙΚΑΡΙΑΣ,1101,168,5,17,173,2021-02-06T00:00:00,681,681,35,716
ΙΩΑΝΝΙΝΩΝ,403,241,138,2,379,2021-02-06T00:00:00,6782,6782,2649,9431
ΚΑΒΑΛΑΣ,104,155,55,5,210,2021-02-06T00:00:00,3473,3473,623,4096
ΚΑΛΥΜΝΟΥ,1203,1,5,-6,6,2021-02-06T00:00:00,677,677,132,809
ΚΑΡΔΙΤΣΑΣ,501,99,45,-24,144,2021-02-06T00:00:00,3678,3678,582,4260
ΚΑΡΠΑΘΟΥ,1204,0,0,0,0,2021-02-06T00:00:00,252,252,15,267
ΚΑΣΤΟΡΙΑΣ,302,70,21,-17,91,2021-02-06T00:00:00,1626,1626,303,1929
ΚΕΑΣ-ΚΥΘΝΟΥ,1205,0,0,0,0,2021-02-06T00:00:00,0,0,0,0
ΚΕΝΤΡΙΚΟΥ ΤΟΜΕΑ ΑΘΗΝΩΝ,905,1804,1321,-154,3125,2021-02-06T00:00:00,49321,49321,18567,67888
ΚΕΡΚΥΡΑΣ,603,104,53,26,157,2021-02-06T00:00:00,2813,2813,249,3062
ΚΕΦΑΛΛΗΝΙΑΣ,604,3,42,19,45,2021-02-06T00:00:00,1612,1612,215,1827
ΚΙΛΚΙΣ,203,43,35,-6,78,2021-02-06T00:00:00,2386,2386,339,2725
ΚΟΖΑΝΗΣ,303,173,38,-17,211,2021-02-06T00:00:00,3329,3329,737,4066
ΚΟΡΙΝΘΙΑΣ,1003,138,18,0,156,2021-02-06T00:00:00,2414,2414,316,2730
ΚΩ,1206,1,17,12,18,2021-02-06T00:00:00,920,920,105,1025
ΛΑΚΩΝΙΑΣ,1004,126,30,-2,156,2021-02-06T00:00:00,2694,2694,398,3092
ΛΑΡΙΣΑΣ,502,235,119,-6,354,2021-02-06T00:00:00,6459,6459,1825,8284
ΛΑΣΙΘΙΟΥ,1302,63,39,-28,102,2021-02-06T00:00:00,3800,3800,554,4354
ΛΕΣΒΟΥ,1102,91,35,7,126,2021-02-06T00:00:00,2467,2467,244,2711
ΛΕΥΚΑΔΑΣ,605,39,15,0,54,2021-02-06T00:00:00,944,944,115,1059
ΛΗΜΝΟΥ,1103,25,5,-12,30,2021-02-06T00:00:00,719,719,161,880
ΜΑΓΝΗΣΙΑΣ,503,168,78,-1,246,2021-02-06T00:00:00,3722,3722,664,4386
ΜΕΣΣΗΝΙΑΣ,1005,213,45,-1,258,2021-02-06T00:00:00,4318,4318,608,4926
ΜΗΛΟΥ,1207,6,0,-19,6,2021-02-06T00:00:00,153,153,2,155
ΜΥΚΟΝΟΥ,1208,0,0,0,0,2021-02-06T00:00:00,144,144,0,144
ΝΑΞΟΥ,1209,1,5,0,6,2021-02-06T00:00:00,426,426,48,474
ΝΗΣΩΝ,906,68,15,-13,83,2021-02-06T00:00:00,1484,1484,40,1524
ΝΟΤΙΟΥ ΤΟΜΕΑ ΑΘΗΝΩΝ,907,217,251,-120,468,2021-02-06T00:00:00,6083,6083,1271,7354
ΞΑΝΘΗΣ,105,52,44,-5,96,2021-02-06T00:00:00,2057,2057,548,2605
ΠΑΡΟΥ,1210,6,0,-6,6,2021-02-06T00:00:00,274,274,2,276
ΠΕΙΡΑΙΩΣ,908,525,141,-269,666,2021-02-06T00:00:00,12515,12515,2806,15321
ΠΕΛΛΑΣ,204,235,30,-24,265,2021-02-06T00:00:00,4205,4205,553,4758
ΠΙΕΡΙΑΣ,205,175,29,-8,204,2021-02-06T00:00:00,3064,3064,428,3492
ΠΡΕΒΕΖΑΣ,404,28,20,-5,48,2021-02-06T00:00:00,1040,1040,338,1378
ΡΕΘΥΜΝΟΥ,1303,37,23,-54,60,2021-02-06T00:00:00,2281,2281,464,2745
ΡΟΔΟΠΗΣ,106,46,26,-6,72,2021-02-06T00:00:00,1626,1626,315,1941
ΡΟΔΟΥ,1211,102,1,-4,103,2021-02-06T00:00:00,2096,2096,422,2518
ΣΑΜΟΥ,1104,33,9,-12,42,2021-02-06T00:00:00,812,812,196,1008
ΣΕΡΡΩΝ,206,116,40,0,156,2021-02-06T00:00:00,2599,2599,643,3242
ΣΠΟΡΑΔΩΝ,504,0,0,0,0,2021-02-06T00:00:00,201,201,3,204
ΣΥΡΟΥ,1212,48,0,0,48,2021-02-06T00:00:00,781,781,162,943
ΤΗΝΟΥ,1213,12,0,6,12,2021-02-06T00:00:00,280,280,1,281
ΤΡΙΚΑΛΩΝ,505,160,45,1,205,2021-02-06T00:00:00,3665,3665,679,4344
ΦΘΙΩΤΙΔΑΣ,804,73,41,-24,114,2021-02-06T00:00:00,2937,2937,706,3643
ΦΛΩΡΙΝΑΣ,304,35,21,-21,56,2021-02-06T00:00:00,1523,1523,263,1786
ΦΩΚΙΔΑΣ,805,39,15,6,54,2021-02-06T00:00:00,898,898,119,1017
ΧΑΛΚΙΔΙΚΗΣ,207,41,19,-17,60,2021-02-06T00:00:00,1863,1863,268,2131
ΧΑΝΙΩΝ,1304,266,53,-12,319,2021-02-06T00:00:00,5987,5987,977,6964
ΧΙΟΥ,1105,23,61,0,84,2021-02-06T00:00:00,1014,1014,257,1271
ΑΙΤΩΛΟΑΚΑΡΝΑΝΙΑΣ,701,181,42,7,223,2021-02-08T00:00:00,3209,3209,883,4092
ΑΝΑΤΟΛΙΚΗΣ ΑΤΤΙΚΗΣ,901,471,41,-12,512,2021-02-08T00:00:00,8275,8275,681,8956
ΑΝΔΡΟΥ,1201,0,0,-6,0,2021-02-08T00:00:00,263,263,1,264
ΑΡΓΟΛΙΔΑΣ,1001,104,63,17,167,2021-02-08T00:00:00,2761,2761,388,3149
ΑΡΚΑΔΙΑΣ,1002,94,38,-13,132,2021-02-08T00:00:00,2665,2665,555,3220
ΑΡΤΑΣ,401,125,25,0,150,2021-02-08T00:00:00,2790,2790,604,3394
ΑΧΑΪΑΣ,702,223,202,-5,425,2021-02-08T00:00:00,9283,9283,2383,11666
ΒΟΙΩΤΙΑΣ,801,98,39,19,137,2021-02-08T00:00:00,2528,2528,408,2936
ΒΟΡΕΙΟΥ ΤΟΜΕΑ ΑΘΗΝΩΝ,902,1334,676,-11,2010,2021-02-08T00:00:00,39970,39970,13320,53290
ΓΡΕΒΕΝΩΝ,301,69,27,48,96,2021-02-08T00:00:00,943,943,240,1183
ΔΡΑΜΑΣ,101,189,39,84,228,2021-02-08T00:00:00,2769,2769,458,3227
ΔΥΤΙΚΗΣ ΑΤΤΙΚΗΣ,903,21,15,-12,36,2021-02-08T00:00:00,2950,2950,568,3518
ΔΥΤΙΚΟΥ ΤΟΜΕΑ ΑΘΗΝΩΝ,904,1077,52,337,1129,2021-02-08T00:00:00,13970,13970,2822,16792
ΕΒΡΟΥ,102,192,115,49,307,2021-02-08T00:00:00,4780,4780,1297,6077
ΕΥΒΟΙΑΣ,802,98,118,20,216,2021-02-08T00:00:00,5574,5574,734,6308
ΕΥΡΥΤΑΝΙΑΣ,803,14,14,-8,28,2021-02-08T00:00:00,630,630,173,803
ΖΑΚΥΝΘΟΥ,601,28,20,-6,48,2021-02-08T00:00:00,1280,1280,188,1468
ΗΛΕΙΑΣ,703,75,72,1,147,2021-02-08T00:00:00,3535,3535,626,4161
ΗΜΑΘΙΑΣ,201,206,60,44,266,2021-02-08T00:00:00,3618,3618,706,4324
ΗΡΑΚΛΕΙΟΥ,1301,181,307,-20,488,2021-02-08T00:00:00,8884,8884,2821,11705
ΘΑΣΟΥ,103,24,0,-6,24,2021-02-08T00:00:00,388,388,13,401
ΘΕΣΠΡΩΤΙΑΣ,402,164,29,91,193,2021-02-08T00:00:00,1966,1966,300,2266
ΘΕΣΣΑΛΟΝΙΚΗΣ,202,1638,638,263,2276,2021-02-08T00:00:00,36266,36266,11246,47512
ΘΗΡΑΣ,1202,7,5,0,12,2021-02-08T00:00:00,318,318,35,353
ΙΘΑΚΗΣ,602,0,0,0,0,2021-02-08T00:00:00,0,0,0,0
ΙΚΑΡΙΑΣ,1101,0,5,-168,5,2021-02-08T00:00:00,681,681,40,721
ΙΩΑΝΝΙΝΩΝ,403,220,158,-1,378,2021-02-08T00:00:00,7002,7002,2807,9809
ΚΑΒΑΛΑΣ,104,203,60,53,263,2021-02-08T00:00:00,3676,3676,683,4359
ΚΑΛΥΜΝΟΥ,1203,3,9,6,12,2021-02-08T00:00:00,680,680,141,821
ΚΑΡΔΙΤΣΑΣ,501,102,54,12,156,2021-02-08T00:00:00,3780,3780,636,4416
ΚΑΡΠΑΘΟΥ,1204,0,0,0,0,2021-02-08T00:00:00,252,252,15,267
ΚΑΣΤΟΡΙΑΣ,302,114,31,54,145,2021-02-08T00:00:00,1740,1740,334,2074
ΚΕΑΣ-ΚΥΘΝΟΥ,1205,0,0,0,0,2021-02-08T00:00:00,0,0,0,0
ΚΕΝΤΡΙΚΟΥ ΤΟΜΕΑ ΑΘΗΝΩΝ,905,2529,686,90,3215,2021-02-08T00:00:00,51850,51850,19253,71103
ΚΕΡΚΥΡΑΣ,603,96,66,5,162,2021-02-08T00:00:00,2909,2909,315,3224
ΚΕΦΑΛΛΗΝΙΑΣ,604,12,24,-9,36,2021-02-08T00:00:00,1624,1624,239,1863
ΚΙΛΚΙΣ,203,142,38,102,180,2021-02-08T00:00:00,2528,2528,377,2905
ΚΟΖΑΝΗΣ,303,261,45,95,306,2021-02-08T00:00:00,3590,3590,782,4372
ΚΟΡΙΝΘΙΑΣ,1003,150,30,24,180,2021-02-08T00:00:00,2564,2564,346,2910
ΚΩ,1206,2,22,6,24,2021-02-08T00:00:00,922,922,127,1049
ΛΑΚΩΝΙΑΣ,1004,88,69,1,157,2021-02-08T00:00:00,2782,2782,467,3249
ΛΑΡΙΣΑΣ,502,247,155,48,402,2021-02-08T00:00:00,6706,6706,1980,8686
ΛΑΣΙΘΙΟΥ,1302,56,40,-6,96,2021-02-08T00:00:00,3856,3856,594,4450
ΛΕΣΒΟΥ,1102,67,35,-24,102,2021-02-08T00:00:00,2534,2534,279,2813
ΛΕΥΚΑΔΑΣ,605,36,18,0,54,2021-02-08T00:00:00,980,980,133,1113
ΛΗΜΝΟΥ,1103,20,4,-6,24,2021-02-08T00:00:00,739,739,165,904
ΜΑΓΝΗΣΙΑΣ,503,175,11,-60,186,2021-02-08T00:00:00,3897,3897,675,4572
ΜΕΣΣΗΝΙΑΣ,1005,221,57,20,278,2021-02-08T00:00:00,4539,4539,665,5204
ΜΗΛΟΥ,1207,35,0,29,35,2021-02-08T00:00:00,188,188,2,190
ΜΥΚΟΝΟΥ,1208,0,0,0,0,2021-02-08T00:00:00,144,144,0,144
ΝΑΞΟΥ,1209,1,11,6,12,2021-02-08T00:00:00,427,427,59,486
ΝΗΣΩΝ,906,54,0,-29,54,2021-02-08T00:00:00,1538,1538,40,1578
ΝΟΤΙΟΥ ΤΟΜΕΑ ΑΘΗΝΩΝ,907,402,71,5,473,2021-02-08T00:00:00,6485,6485,1342,7827
ΞΑΝΘΗΣ,105,100,56,60,156,2021-02-08T00:00:00,2157,2157,604,2761
ΠΑΡΟΥ,1210,6,0,0,6,2021-02-08T00:00:00,280,280,2,282
ΠΕΙΡΑΙΩΣ,908,726,116,176,842,2021-02-08T00:00:00,13241,13241,2922,16163
ΠΕΛΛΑΣ,204,299,53,87,352,2021-02-08T00:00:00,4504,4504,606,5110
ΠΙΕΡΙΑΣ,205,187,35,18,222,2021-02-08T00:00:00,3251,3251,463,3714
ΠΡΕΒΕΖΑΣ,404,32,28,12,60,2021-02-08T00:00:00,1072,1072,366,1438
ΡΕΘΥΜΝΟΥ,1303,35,22,-3,57,2021-02-08T00:00:00,2316,2316,486,2802
ΡΟΔΟΠΗΣ,106,97,23,48,120,2021-02-08T00:00:00,1723,1723,338,2061
ΡΟΔΟΥ,1211,150,0,47,150,2021-02-08T00:00:00,2246,2246,422,2668
ΣΑΜΟΥ,1104,37,11,6,48,2021-02-08T00:00:00,849,849,207,1056
ΣΕΡΡΩΝ,206,193,41,78,234,2021-02-08T00:00:00,2792,2792,684,3476
ΣΠΟΡΑΔΩΝ,504,0,0,0,0,2021-02-08T00:00:00,201,201,3,204
ΣΥΡΟΥ,1212,54,0,6,54,2021-02-08T00:00:00,835,835,162,997
ΤΗΝΟΥ,1213,0,0,-12,0,2021-02-08T00:00:00,280,280,1,281
ΤΡΙΚΑΛΩΝ,505,233,73,101,306,2021-02-08T00:00:00,3898,3898,752,4650
ΦΘΙΩΤΙΔΑΣ,804,113,55,54,168,2021-02-08T00:00:00,3050,3050,761,3811
ΦΛΩΡΙΝΑΣ,304,46,19,9,65,2021-02-08T00:00:00,1569,1569,282,1851
ΦΩΚΙΔΑΣ,805,56,10,12,66,2021-02-08T00:00:00,954,954,129,1083
ΧΑΛΚΙΔΙΚΗΣ,207,170,28,138,198,2021-02-08T00:00:00,2033,2033,296,2329
ΧΑΝΙΩΝ,1304,262,61,4,323,2021-02-08T00:00:00,6249,6249,1038,7287
ΧΙΟΥ,1105,70,26,12,96,2021-02-08T00:00:00,1084,1084,283,1367
ΑΙΤΩΛΟΑΚΑΡΝΑΝΙΑΣ,701,144,52,-27,196,2021-02-09T00:00:00,3353,3353,935,4288
ΑΝΑΤΟΛΙΚΗΣ ΑΤΤΙΚΗΣ,901,487,46,21,533,2021-02-09T00:00:00,8762,8762,727,9489
ΑΝΔΡΟΥ,1201,0,0,0,0,2021-02-09T00:00:00,263,263,1,264
ΑΡΓΟΛΙΔΑΣ,1001,33,131,-3,164,2021-02-09T00:00:00,2794,2794,519,3313
ΑΡΚΑΔΙΑΣ,1002,56,46,-30,102,2021-02-09T00:00:00,2721,2721,601,3322
ΑΡΤΑΣ,401,130,29,9,159,2021-02-09T00:00:00,2920,2920,633,3553
ΑΧΑΪΑΣ,702,128,174,-123,302,2021-02-09T00:00:00,9411,9411,2557,11968
ΒΟΙΩΤΙΑΣ,801,53,57,-27,110,2021-02-09T00:00:00,2581,2581,465,3046
ΒΟΡΕΙΟΥ ΤΟΜΕΑ ΑΘΗΝΩΝ,902,1124,1341,455,2465,2021-02-09T00:00:00,41094,41094,14661,55755
ΓΡΕΒΕΝΩΝ,301,73,41,18,114,2021-02-09T00:00:00,1016,1016,281,1297
ΔΡΑΜΑΣ,101,139,59,-30,198,2021-02-09T00:00:00,2908,2908,517,3425
ΔΥΤΙΚΗΣ ΑΤΤΙΚΗΣ,903,5,19,-12,24,2021-02-09T00:00:00,2955,2955,587,3542
ΔΥΤΙΚΟΥ ΤΟΜΕΑ ΑΘΗΝΩΝ,904,1079,212,162,1291,2021-02-09T00:00:00,15049,15049,3034,18083
ΕΒΡΟΥ,102,163,143,-1,306,2021-02-09T00:00:00,4943,4943,1440,6383
ΕΥΒΟΙΑΣ,802,60,203,47,263,2021-02-09T00:00:00,5634,5634,937,6571
ΕΥΡΥΤΑΝΙΑΣ,803,8,36,16,44,2021-02-09T00:00:00,638,638,209,847
ΖΑΚΥΝΘΟΥ,601,9,51,12,60,2021-02-09T00:00:00,1289,1289,239,1528
ΗΛΕΙΑΣ,703,53,125,31,178,2021-02-09T00:00:00,3588,3588,751,4339
ΗΜΑΘΙΑΣ,201,205,60,-1,265,2021-02-09T00:00:00,3823,3823,766,4589
ΗΡΑΚΛΕΙΟΥ,1301,87,332,-69,419,2021-02-09T00:00:00,8971,8971,3153,12124
ΘΑΣΟΥ,103,12,0,-12,12,2021-02-09T00:00:00,400,400,13,413
ΘΕΣΠΡΩΤΙΑΣ,402,79,83,-31,162,2021-02-09T00:00:00,2045,2045,383,2428
ΘΕΣΣΑΛΟΝΙΚΗΣ,202,1396,731,-149,2127,2021-02-09T00:00:00,37662,37662,11977,49639
ΘΗΡΑΣ,1202,0,30,18,30,2021-02-09T00:00:00,318,318,65,383
ΙΘΑΚΗΣ,602,0,0,0,0,2021-02-09T00:00:00,0,0,0,0
ΙΚΑΡΙΑΣ,1101,1,22,18,23,2021-02-09T00:00:00,682,682,62,744
ΙΩΑΝΝΙΝΩΝ,403,201,137,-40,338,2021-02-09T00:00:00,7203,7203,2944,10147
ΚΑΒΑΛΑΣ,104,191,61,-11,252,2021-02-09T00:00:00,3867,3867,744,4611
ΚΑΛΥΜΝΟΥ,1203,1,5,-6,6,2021-02-09T00:00:00,681,681,146,827
ΚΑΡΔΙΤΣΑΣ,501,57,63,-36,120,2021-02-09T00:00:00,3837,3837,699,4536
ΚΑΡΠΑΘΟΥ,1204,0,0,0,0,2021-02-09T00:00:00,252,252,15,267
ΚΑΣΤΟΡΙΑΣ,302,114,35,4,149,2021-02-09T00:00:00,1854,1854,369,2223
ΚΕΑΣ-ΚΥΘΝΟΥ,1205,0,0,0,0,2021-02-09T00:00:00,0,0,0,0
ΚΕΝΤΡΙΚΟΥ ΤΟΜΕΑ ΑΘΗΝΩΝ,905,2383,949,117,3332,2021-02-09T00:00:00,54233,54233,20202,74435
ΚΕΡΚΥΡΑΣ,603,100,103,41,203,2021-02-09T00:00:00,3009,3009,418,3427
ΚΕΦΑΛΛΗΝΙΑΣ,604,1,125,90,126,2021-02-09T00:00:00,1625,1625,364,1989
ΚΙΛΚΙΣ,203,118,62,0,180,2021-02-09T00:00:00,2646,2646,439,3085
ΚΟΖΑΝΗΣ,303,199,113,6,312,2021-02-09T00:00:00,3789,3789,895,4684
ΚΟΡΙΝΘΙΑΣ,1003,126,30,-24,156,2021-02-09T00:00:00,2690,2690,376,3066
ΚΩ,1206,3,57,36,60,2021-02-09T00:00:00,925,925,184,1109
ΛΑΚΩΝΙΑΣ,1004,15,138,-4,153,2021-02-09T00:00:00,2797,2797,605,3402
ΛΑΡΙΣΑΣ,502,248,100,-54,348,2021-02-09T00:00:00,6954,6954,2080,9034
ΛΑΣΙΘΙΟΥ,1302,15,194,113,209,2021-02-09T00:00:00,3871,3871,788,4659
ΛΕΣΒΟΥ,1102,8,166,72,174,2021-02-09T00:00:00,2542,2542,445,2987
ΛΕΥΚΑΔΑΣ,605,255,35,236,290,2021-02-09T00:00:00,1235,1235,168,1403
ΛΗΜΝΟΥ,1103,7,53,36,60,2021-02-09T00:00:00,746,746,218,964
ΜΑΓΝΗΣΙΑΣ,503,108,42,-36,150,2021-02-09T00:00:00,4005,4005,717,4722
ΜΕΣΣΗΝΙΑΣ,1005,162,97,-19,259,2021-02-09T00:00:00,4701,4701,762,5463
ΜΗΛΟΥ,1207,0,0,-35,0,2021-02-09T00:00:00,188,188,2,190
ΜΥΚΟΝΟΥ,1208,0,0,0,0,2021-02-09T00:00:00,144,144,0,144
ΝΑΞΟΥ,1209,5,11,4,16,2021-02-09T00:00:00,432,432,70,502
ΝΗΣΩΝ,906,29,17,-8,46,2021-02-09T00:00:00,1567,1567,57,1624
ΝΟΤΙΟΥ ΤΟΜΕΑ ΑΘΗΝΩΝ,907,450,98,75,548,2021-02-09T00:00:00,6935,6935,1440,8375
ΞΑΝΘΗΣ,105,87,57,-12,144,2021-02-09T00:00:00,2244,2244,661,2905
ΠΑΡΟΥ,1210,0,0,-6,0,2021-02-09T00:00:00,280,280,2,282
ΠΕΙΡΑΙΩΣ,908,612,210,-20,822,2021-02-09T00:00:00,13853,13853,3132,16985
ΠΕΛΛΑΣ,204,171,76,-105,247,2021-02-09T00:00:00,4675,4675,682,5357
ΠΙΕΡΙΑΣ,205,146,52,-24,198,2021-02-09T00:00:00,3397,3397,515,3912
ΠΡΕΒΕΖΑΣ,404,7,44,-9,51,2021-02-09T00:00:00,1079,1079,410,1489
ΡΕΘΥΜΝΟΥ,1303,30,45,18,75,2021-02-09T00:00:00,2346,2346,531,2877
ΡΟΔΟΠΗΣ,106,68,46,-6,114,2021-02-09T00:00:00,1791,1791,384,2175
ΡΟΔΟΥ,1211,74,84,8,158,2021-02-09T00:00:00,2320,2320,506,2826
ΣΑΜΟΥ,1104,27,27,6,54,2021-02-09T00:00:00,876,876,234,1110
ΣΕΡΡΩΝ,206,138,72,-24,210,2021-02-09T00:00:00,2930,2930,756,3686
ΣΠΟΡΑΔΩΝ,504,0,0,0,0,2021-02-09T00:00:00,201,201,3,204
ΣΥΡΟΥ,1212,28,26,0,54,2021-02-09T00:00:00,863,863,188,1051
ΤΗΝΟΥ,1213,0,0,0,0,2021-02-09T00:00:00,280,280,1,281
ΤΡΙΚΑΛΩΝ,505,182,70,-54,252,2021-02-09T00:00:00,4080,4080,822,4902
ΦΘΙΩΤΙΔΑΣ,804,93,57,-18,150,2021-02-09T00:00:00,3143,3143,818,3961
ΦΛΩΡΙΝΑΣ,304,32,30,-3,62,2021-02-09T00:00:00,1601,1601,312,1913
ΦΩΚΙΔΑΣ,805,3,45,-18,48,2021-02-09T00:00:00,957,957,174,1131
ΧΑΛΚΙΔΙΚΗΣ,207,138,30,-30,168,2021-02-09T00:00:00,2171,2171,326,2497
ΧΑΝΙΩΝ,1304,269,102,48,371,2021-02-09T00:00:00,6518,6518,1140,7658
ΧΙΟΥ,1105,53,42,-1,95,2021-02-09T00:00:00,1137,1137,325,1462
ΑΙΤΩΛΟΑΚΑΡΝΑΝΙΑΣ,701,123,69,-4,192,2021-02-10T00:00:00,3476,3476,1004,4480
ΑΝΑΤΟΛΙΚΗΣ ΑΤΤΙΚΗΣ,901,218,263,-52,481,2021-02-10T00:00:00,8980,8980,990,9970
ΑΝΔΡΟΥ,1201,0,0,0,0,2021-02-10T00:00:00,263,263,1,264
ΑΡΓΟΛΙΔΑΣ,1001,11,169,16,180,2021-02-10T00:00:00,2805,2805,688,3493
ΑΡΚΑΔΙΑΣ,1002,22,104,24,126,2021-02-10T00:00:00,2743,2743,705,3448
ΑΡΤΑΣ,401,27,129,-3,156,2021-02-10T00:00:00,2947,2947,762,3709
ΑΧΑΪΑΣ,702,85,393,176,478,2021-02-10T00:00:00,9496,9496,2950,12446
ΒΟΙΩΤΙΑΣ,801,19,148,57,167,2021-02-10T00:00:00,2600,2600,613,3213
ΒΟΡΕΙΟΥ ΤΟΜΕΑ ΑΘΗΝΩΝ,902,529,1601,-335,2130,2021-02-10T00:00:00,41623,41623,16262,57885
ΓΡΕΒΕΝΩΝ,301,67,35,-12,102,2021-02-10T00:00:00,1083,1083,316,1399
ΔΡΑΜΑΣ,101,74,146,22,220,2021-02-10T00:00:00,2982,2982,663,3645
ΔΥΤΙΚΗΣ ΑΤΤΙΚΗΣ,903,11,115,102,126,2021-02-10T00:00:00,2966,2966,702,3668
ΔΥΤΙΚΟΥ ΤΟΜΕΑ ΑΘΗΝΩΝ,904,757,434,-100,1191,2021-02-10T00:00:00,15806,15806,3468,19274
ΕΒΡΟΥ,102,67,287,48,354,2021-02-10T00:00:00,5010,5010,1727,6737
ΕΥΒΟΙΑΣ,802,18,402,157,420,2021-02-10T00:00:00,5652,5652,1339,6991
ΕΥΡΥΤΑΝΙΑΣ,803,6,30,-8,36,2021-02-10T00:00:00,644,644,239,883
ΖΑΚΥΝΘΟΥ,601,7,95,42,102,2021-02-10T00:00:00,1296,1296,334,1630
ΗΛΕΙΑΣ,703,23,159,4,182,2021-02-10T00:00:00,3611,3611,910,4521
ΗΜΑΘΙΑΣ,201,123,135,-7,258,2021-02-10T00:00:00,3946,3946,901,4847
ΗΡΑΚΛΕΙΟΥ,1301,60,538,179,598,2021-02-10T00:00:00,9031,9031,3691,12722
ΘΑΣΟΥ,103,5,1,-6,6,2021-02-10T00:00:00,405,405,14,419
ΘΕΣΠΡΩΤΙΑΣ,402,59,90,-13,149,2021-02-10T00:00:00,2104,2104,473,2577
ΘΕΣΣΑΛΟΝΙΚΗΣ,202,947,1394,214,2341,2021-02-10T00:00:00,38609,38609,13371,51980
ΘΗΡΑΣ,1202,9,15,-6,24,2021-02-10T00:00:00,327,327,80,407
ΙΘΑΚΗΣ,602,0,0,0,0,2021-02-10T00:00:00,0,0,0,0
ΙΚΑΡΙΑΣ,1101,2,16,-5,18,2021-02-10T00:00:00,684,684,78,762
ΙΩΑΝΝΙΝΩΝ,403,133,241,36,374,2021-02-10T00:00:00,7336,7336,3185,10521
ΚΑΒΑΛΑΣ,104,105,147,0,252,2021-02-10T00:00:00,3972,3972,891,4863
ΚΑΛΥΜΝΟΥ,1203,2,34,30,36,2021-02-10T00:00:00,683,683,180,863
ΚΑΡΔΙΤΣΑΣ,501,24,221,125,245,2021-02-10T00:00:00,3861,3861,920,4781
ΚΑΡΠΑΘΟΥ,1204,0,12,12,12,2021-02-10T00:00:00,252,252,27,279
ΚΑΣΤΟΡΙΑΣ,302,61,59,-29,120,2021-02-10T00:00:00,1915,1915,428,2343
ΚΕΑΣ-ΚΥΘΝΟΥ,1205,0,0,0,0,2021-02-10T00:00:00,0,0,0,0
ΚΕΝΤΡΙΚΟΥ ΤΟΜΕΑ ΑΘΗΝΩΝ,905,1815,1590,73,3405,2021-02-10T00:00:00,56048,56048,21792,77840
ΚΕΡΚΥΡΑΣ,603,19,222,38,241,2021-02-10T00:00:00,3028,3028,640,3668
ΚΕΦΑΛΛΗΝΙΑΣ,604,4,132,10,136,2021-02-10T00:00:00,1629,1629,496,2125
ΚΙΛΚΙΣ,203,131,182,133,313,2021-02-10T00:00:00,2777,2777,621,3398
ΚΟΖΑΝΗΣ,303,193,107,-12,300,2021-02-10T00:00:00,3982,3982,1002,4984
ΚΟΡΙΝΘΙΑΣ,1003,80,70,-6,150,2021-02-10T00:00:00,2770,2770,446,3216
ΚΩ,1206,2,64,6,66,2021-02-10T00:00:00,927,927,248,1175
ΛΑΚΩΝΙΑΣ,1004,12,150,9,162,2021-02-10T00:00:00,2809,2809,755,3564
ΛΑΡΙΣΑΣ,502,175,197,24,372,2021-02-10T00:00:00,7129,7129,2277,9406
ΛΑΣΙΘΙΟΥ,1302,19,238,48,257,2021-02-10T00:00:00,3890,3890,1026,4916
ΛΕΣΒΟΥ,1102,15,147,-12,162,2021-02-10T00:00:00,2557,2557,592,3149
ΛΕΥΚΑΔΑΣ,605,94,45,-151,139,2021-02-10T00:00:00,1329,1329,213,1542
ΛΗΜΝΟΥ,1103,7,41,-12,48,2021-02-10T00:00:00,753,753,259,1012
ΜΑΓΝΗΣΙΑΣ,503,113,72,35,185,2021-02-10T00:00:00,4118,4118,789,4907
ΜΕΣΣΗΝΙΑΣ,1005,84,173,-2,257,2021-02-10T00:00:00,4785,4785,935,5720
ΜΗΛΟΥ,1207,24,0,24,24,2021-02-10T00:00:00,212,212,2,214
ΜΥΚΟΝΟΥ,1208,0,0,0,0,2021-02-10T00:00:00,144,144,0,144
ΝΑΞΟΥ,1209,2,28,14,30,2021-02-10T00:00:00,434,434,98,532
ΝΗΣΩΝ,906,29,19,2,48,2021-02-10T00:00:00,1596,1596,76,1672
ΝΟΤΙΟΥ ΤΟΜΕΑ ΑΘΗΝΩΝ,907,283,268,3,551,2021-02-10T00:00:00,7218,7218,1708,8926
ΞΑΝΘΗΣ,105,38,113,7,151,2021-02-10T00:00:00,2282,2282,774,3056
ΠΑΡΟΥ,1210,6,0,6,6,2021-02-10T00:00:00,286,286,2,288
ΠΕΙΡΑΙΩΣ,908,273,445,-104,718,2021-02-10T00:00:00,14126,14126,3577,17703
ΠΕΛΛΑΣ,204,123,194,70,317,2021-02-10T00:00:00,4798,4798,876,5674
ΠΙΕΡΙΑΣ,205,117,105,24,222,2021-02-10T00:00:00,3514,3514,620,4134
ΠΡΕΒΕΖΑΣ,404,12,45,6,57,2021-02-10T00:00:00,1091,1091,455,1546
ΡΕΘΥΜΝΟΥ,1303,24,150,99,174,2021-02-10T00:00:00,2370,2370,681,3051
ΡΟΔΟΠΗΣ,106,67,89,42,156,2021-02-10T00:00:00,1858,1858,473,2331
ΡΟΔΟΥ,1211,39,93,-26,132,2021-02-10T00:00:00,2359,2359,599,2958
ΣΑΜΟΥ,1104,5,43,-6,48,2021-02-10T00:00:00,881,881,277,1158
ΣΕΡΡΩΝ,206,100,122,12,222,2021-02-10T00:00:00,3030,3030,878,3908
ΣΠΟΡΑΔΩΝ,504,18,0,18,18,2021-02-10T00:00:00,219,219,3,222
ΣΥΡΟΥ,1212,8,46,0,54,2021-02-10T00:00:00,871,871,234,1105
ΤΗΝΟΥ,1213,0,0,0,0,2021-02-10T00:00:00,280,280,1,281
ΤΡΙΚΑΛΩΝ,505,87,178,13,265,2021-02-10T00:00:00,4167,4167,1000,5167
ΦΘΙΩΤΙΔΑΣ,804,102,132,84,234,2021-02-10T00:00:00,3245,3245,950,4195
ΦΛΩΡΙΝΑΣ,304,26,64,28,90,2021-02-10T00:00:00,1627,1627,376,2003
ΦΩΚΙΔΑΣ,805,7,45,4,52,2021-02-10T00:00:00,964,964,219,1183
ΧΑΛΚΙΔΙΚΗΣ,207,99,87,18,186,2021-02-10T00:00:00,2270,2270,413,2683
ΧΑΝΙΩΝ,1304,76,333,38,409,2021-02-10T00:00:00,6594,6594,1473,8067
ΧΙΟΥ,1105,200,30,135,230,2021-02-10T00:00:00,1337,1337,355,1692
ΑΙΤΩΛΟΑΚΑΡΝΑΝΙΑΣ,701,475,111,175,586,2021-04-01T00:00:00,15182,15182,5616,20798
ΑΝΑΤΟΛΙΚΗΣ ΑΤΤΙΚΗΣ,901,745,404,353,1149,2021-04-01T00:00:00,31803,31803,13230,45033
ΑΝΔΡΟΥ,1201,40,8,18,48,2021-04-01T00:00:00,686,686,305,991
ΑΡΓΟΛΙΔΑΣ,1001,178,121,40,299,2021-04-01T00:00:00,8903,8903,4441,13344
ΑΡΚΑΔΙΑΣ,1002,162,112,-43,274,2021-04-01T00:00:00,9025,9025,4195,13220
ΑΡΤΑΣ,401,136,87,53,223,2021-04-01T00:00:00,6602,6602,4547,11149
ΑΧΑΪΑΣ,702,373,445,53,818,2021-04-01T00:00:00,25872,25872,15366,41238
ΒΟΙΩΤΙΑΣ,801,193,167,-38,360,2021-04-01T00:00:00,12470,12470,4922,17392
ΒΟΡΕΙΟΥ ΤΟΜΕΑ ΑΘΗΝΩΝ,902,1233,3129,596,4362,2021-04-01T00:00:00,139197,139198,91272,230470
ΓΡΕΒΕΝΩΝ,301,52,69,-3,121,2021-04-01T00:00:00,3617,3617,2150,5767
ΔΡΑΜΑΣ,101,89,152,-8,241,2021-04-01T00:00:00,8471,8471,5215,13686
ΔΥΤΙΚΗΣ ΑΤΤΙΚΗΣ,903,122,133,-20,255,2021-04-01T00:00:00,9379,9379,5198,14577
ΔΥΤΙΚΟΥ ΤΟΜΕΑ ΑΘΗΝΩΝ,904,1058,910,727,1968,2021-04-01T00:00:00,45198,45198,25271,70469
ΕΒΡΟΥ,102,224,263,19,487,2021-04-01T00:00:00,15541,15541,8916,24457
ΕΥΒΟΙΑΣ,802,450,354,97,804,2021-04-01T00:00:00,18652,18652,10792,29444
ΕΥΡΥΤΑΝΙΑΣ,803,21,30,-4,51,2021-04-01T00:00:00,1789,1789,1088,2877
ΖΑΚΥΝΘΟΥ,601,63,57,-21,120,2021-04-01T00:00:00,3226,3226,2233,5459
ΗΛΕΙΑΣ,703,208,204,17,412,2021-04-01T00:00:00,11691,11691,6277,17968
ΗΜΑΘΙΑΣ,201,172,136,7,308,2021-04-01T00:00:00,12347,12347,6826,19173
ΗΡΑΚΛΕΙΟΥ,1301,530,318,128,848,2021-04-01T00:00:00,26741,26741,15303,42044
ΘΑΣΟΥ,103,28,1,-12,29,2021-04-01T00:00:00,838,838,455,1293
ΘΕΣΠΡΩΤΙΑΣ,402,91,125,19,216,2021-04-01T00:00:00,6503,6503,3738,10241
ΘΕΣΣΑΛΟΝΙΚΗΣ,202,3142,2241,1814,5383,2021-04-01T00:00:00,121107,121109,74565,195674
ΘΗΡΑΣ,1202,28,14,10,42,2021-04-01T00:00:00,1251,1251,737,1988
ΙΘΑΚΗΣ,602,0,0,-30,0,2021-04-01T00:00:00,836,836,574,1410
ΙΚΑΡΙΑΣ,1101,21,22,4,43,2021-04-01T00:00:00,1524,1524,1123,2647
ΙΩΑΝΝΙΝΩΝ,403,371,184,137,555,2021-04-01T00:00:00,18871,18872,11541,30413
ΚΑΒΑΛΑΣ,104,247,171,73,418,2021-04-01T00:00:00,11311,11311,6678,17989
ΚΑΛΥΜΝΟΥ,1203,275,7,244,282,2021-04-01T00:00:00,1859,1859,1448,3307
ΚΑΡΔΙΤΣΑΣ,501,310,91,30,401,2021-04-01T00:00:00,13802,13802,6067,19869
ΚΑΡΠΑΘΟΥ,1204,1,5,-36,6,2021-04-01T00:00:00,809,809,461,1270
ΚΑΣΤΟΡΙΑΣ,302,58,128,-8,186,2021-04-01T00:00:00,6415,6415,3480,9895
ΚΕΑΣ-ΚΥΘΝΟΥ,1205,0,18,-5,18,2021-04-01T00:00:00,716,716,90,806
ΚΕΝΤΡΙΚΟΥ ΤΟΜΕΑ ΑΘΗΝΩΝ,905,2550,2146,1292,4696,2021-04-01T00:00:00,153673,153674,89410,243084
ΚΕΡΚΥΡΑΣ,603,153,207,28,360,2021-04-01T00:00:00,9500,9500,5467,14967
ΚΕΦΑΛΛΗΝΙΑΣ,604,58,70,-35,128,2021-04-01T00:00:00,4289,4289,2772,7061
ΚΙΛΚΙΣ,203,76,157,-64,233,2021-04-01T00:00:00,8240,8240,5617,13857
ΚΟΖΑΝΗΣ,303,231,187,98,418,2021-04-01T00:00:00,13848,13848,6955,20803
ΚΟΡΙΝΘΙΑΣ,1003,337,102,156,439,2021-04-01T00:00:00,11433,11433,4342,15775
ΚΩ,1206,57,47,27,104,2021-04-01T00:00:00,3555,3555,2040,5595
ΛΑΚΩΝΙΑΣ,1004,181,59,-28,240,2021-04-01T00:00:00,8675,8675,4461,13136
ΛΑΡΙΣΑΣ,502,678,122,196,800,2021-04-01T00:00:00,23595,23595,10355,33950
ΛΑΣΙΘΙΟΥ,1302,144,165,-4,309,2021-04-01T00:00:00,9382,9382,6595,15977
ΛΕΣΒΟΥ,1102,130,125,57,255,2021-04-01T00:00:00,6913,6913,3898,10811
ΛΕΥΚΑΔΑΣ,605,61,50,9,111,2021-04-01T00:00:00,3748,3748,2170,5918
ΛΗΜΝΟΥ,1103,38,42,-95,80,2021-04-01T00:00:00,1943,1943,1212,3155
ΜΑΓΝΗΣΙΑΣ,503,241,259,30,500,2021-04-01T00:00:00,15445,15445,7925,23370
ΜΕΣΣΗΝΙΑΣ,1005,313,165,43,478,2021-04-01T00:00:00,13286,13286,7589,20875
ΜΗΛΟΥ,1207,30,0,6,30,2021-04-01T00:00:00,1829,1829,443,2272
ΜΥΚΟΝΟΥ,1208,8,3,5,11,2021-04-01T00:00:00,467,467,175,642
ΝΑΞΟΥ,1209,16,20,1,36,2021-04-01T00:00:00,917,917,808,1725
ΝΗΣΩΝ,906,139,105,-70,244,2021-04-01T00:00:00,5896,5896,2980,8876
ΝΟΤΙΟΥ ΤΟΜΕΑ ΑΘΗΝΩΝ,907,1869,317,1513,2186,2021-04-01T00:00:00,31893,31893,12380,44273
ΞΑΝΘΗΣ,105,108,126,25,234,2021-04-01T00:00:00,7211,7211,4397,11608
ΠΑΡΟΥ,1210,85,0,-16,85,2021-04-01T00:00:00,828,828,317,1145
ΠΕΙΡΑΙΩΣ,908,506,752,154,1258,2021-04-01T00:00:00,45510,45510,23918,69428
ΠΕΛΛΑΣ,204,102,252,83,354,2021-04-01T00:00:00,13560,13561,7848,21409
ΠΙΕΡΙΑΣ,205,174,192,100,366,2021-04-01T00:00:00,9793,9793,5881,15674
ΠΡΕΒΕΖΑΣ,404,211,20,59,231,2021-04-01T00:00:00,6457,6457,1802,8259
ΡΕΘΥΜΝΟΥ,1303,78,137,2,215,2021-04-01T00:00:00,7920,7920,4670,12590
ΡΟΔΟΠΗΣ,106,199,86,54,285,2021-04-01T00:00:00,7068,7068,3711,10779
ΡΟΔΟΥ,1211,150,160,87,310,2021-04-01T00:00:00,8638,8638,4938,13576
ΣΑΜΟΥ,1104,37,42,-5,79,2021-04-01T00:00:00,2754,2754,1340,4094
ΣΕΡΡΩΝ,206,347,125,34,472,2021-04-01T00:00:00,13801,13801,5723,19524
ΣΠΟΡΑΔΩΝ,504,13,23,-18,36,2021-04-01T00:00:00,856,856,434,1290
ΣΥΡΟΥ,1212,45,40,0,85,2021-04-01T00:00:00,2318,2318,1271,3589
ΤΗΝΟΥ,1213,23,1,-12,24,2021-04-01T00:00:00,685,685,316,1001
ΤΡΙΚΑΛΩΝ,505,307,100,72,407,2021-04-01T00:00:00,13602,13602,7053,20655
ΦΘΙΩΤΙΔΑΣ,804,388,154,200,542,2021-04-01T00:00:00,12103,12103,6325,18428
ΦΛΩΡΙΝΑΣ,304,28,139,7,167,2021-04-01T00:00:00,5019,5019,3158,8177
ΦΩΚΙΔΑΣ,805,113,30,59,143,2021-04-01T00:00:00,2974,2974,1532,4506
ΧΑΛΚΙΔΙΚΗΣ,207,120,183,-80,303,2021-04-01T00:00:00,9763,9763,5197,14960
ΧΑΝΙΩΝ,1304,179,334,6,513,2021-04-01T00:00:00,17281,17281,10363,27644
ΧΙΟΥ,1105,111,53,31,164,2021-04-01T00:00:00,5461,5462,2773,8235
ΑΙΤΩΛΟΑΚΑΡΝΑΝΙΑΣ,701,544,86,44,630,2021-04-02T00:00:00,15726,15726,5702,21428
ΑΝΑΤΟΛΙΚΗΣ ΑΤΤΙΚΗΣ,901,656,450,-43,1106,2021-04-02T00:00:00,32459,32459,13680,46139
ΑΝΔΡΟΥ,1201,31,4,-13,35,2021-04-02T00:00:00,717,717,309,1026
ΑΡΓΟΛΙΔΑΣ,1001,185,111,-3,296,2021-04-02T00:00:00,9088,9088,4552,13640
ΑΡΚΑΔΙΑΣ,1002,202,144,72,346,2021-04-02T00:00:00,9227,9227,4339,13566
ΑΡΤΑΣ,401,184,61,22,245,2021-04-02T00:00:00,6786,6786,4608,11394
ΑΧΑΪΑΣ,702,376,426,-16,802,2021-04-02T00:00:00,26248,26248,15792,42040
ΒΟΙΩΤΙΑΣ,801,234,135,9,369,2021-04-02T00:00:00,12704,12704,5057,17761
ΒΟΡΕΙΟΥ ΤΟΜΕΑ ΑΘΗΝΩΝ,902,1458,2981,77,4439,2021-04-02T00:00:00,140655,140656,94253,234909
ΓΡΕΒΕΝΩΝ,301,63,64,6,127,2021-04-02T00:00:00,3680,3680,2214,5894
ΔΡΑΜΑΣ,101,151,117,27,268,2021-04-02T00:00:00,8622,8622,5332,13954
ΔΥΤΙΚΗΣ ΑΤΤΙΚΗΣ,903,186,106,37,292,2021-04-02T00:00:00,9565,9565,5304,14869
ΔΥΤΙΚΟΥ ΤΟΜΕΑ ΑΘΗΝΩΝ,904,715,904,-349,1619,2021-04-02T00:00:00,45913,45913,26175,72088
ΕΒΡΟΥ,102,282,190,-15,472,2021-04-02T00:00:00,15823,15823,9106,24929
ΕΥΒΟΙΑΣ,802,513,239,-52,752,2021-04-02T00:00:00,19165,19165,11031,30196
ΕΥΡΥΤΑΝΙΑΣ,803,20,44,13,64,2021-04-02T00:00:00,1809,1809,1132,2941
ΖΑΚΥΝΘΟΥ,601,66,70,16,136,2021-04-02T00:00:00,3292,3292,2303,5595
ΗΛΕΙΑΣ,703,242,211,41,453,2021-04-02T00:00:00,11933,11933,6488,18421
ΗΜΑΘΙΑΣ,201,257,117,66,374,2021-04-02T00:00:00,12604,12604,6943,19547
ΗΡΑΚΛΕΙΟΥ,1301,583,304,39,887,2021-04-02T00:00:00,27324,27324,15607,42931
ΘΑΣΟΥ,103,48,2,21,50,2021-04-02T00:00:00,886,886,457,1343
ΘΕΣΠΡΩΤΙΑΣ,402,107,123,14,230,2021-04-02T00:00:00,6610,6610,3861,10471
ΘΕΣΣΑΛΟΝΙΚΗΣ,202,1994,2314,-1075,4308,2021-04-02T00:00:00,123101,123103,76879,199982
ΘΗΡΑΣ,1202,25,54,37,79,2021-04-02T00:00:00,1276,1276,791,2067
ΙΘΑΚΗΣ,602,1,71,72,72,2021-04-02T00:00:00,837,837,645,1482
ΙΚΑΡΙΑΣ,1101,28,19,4,47,2021-04-02T00:00:00,1552,1552,1142,2694
ΙΩΑΝΝΙΝΩΝ,403,363,215,23,578,2021-04-02T00:00:00,19234,19235,11756,30991
ΚΑΒΑΛΑΣ,104,268,145,-5,413,2021-04-02T00:00:00,11579,11579,6823,18402
ΚΑΛΥΜΝΟΥ,1203,183,5,-94,188,2021-04-02T00:00:00,2042,2042,1453,3495
ΚΑΡΔΙΤΣΑΣ,501,335,94,28,429,2021-04-02T00:00:00,14137,14137,6161,20298
ΚΑΡΠΑΘΟΥ,1204,1,5,0,6,2021-04-02T00:00:00,810,810,466,1276
ΚΑΣΤΟΡΙΑΣ,302,95,102,11,197,2021-04-02T00:00:00,6510,6510,3582,10092
ΚΕΑΣ-ΚΥΘΝΟΥ,1205,0,24,6,24,2021-04-02T00:00:00,716,716,114,830
ΚΕΝΤΡΙΚΟΥ ΤΟΜΕΑ ΑΘΗΝΩΝ,905,3067,2279,650,5346,2021-04-02T00:00:00,156740,156741,91689,248430
ΚΕΡΚΥΡΑΣ,603,154,192,-14,346,2021-04-02T00:00:00,9654,9654,5659,15313
ΚΕΦΑΛΛΗΝΙΑΣ,604,87,58,17,145,2021-04-02T00:00:00,4376,4376,2830,7206
ΚΙΛΚΙΣ,203,105,144,16,249,2021-04-02T00:00:00,8345,8345,5761,14106
ΚΟΖΑΝΗΣ,303,239,218,39,457,2021-04-02T00:00:00,14087,14087,7173,21260
ΚΟΡΙΝΘΙΑΣ,1003,332,92,-15,424,2021-04-02T00:00:00,11765,11765,4434,16199
ΚΩ,1206,78,36,10,114,2021-04-02T00:00:00,3633,3633,2076,5709
ΛΑΚΩΝΙΑΣ,1004,179,34,-27,213,2021-04-02T00:00:00,8854,8854,4495,13349
ΛΑΡΙΣΑΣ,502,720,139,59,859,2021-04-02T00:00:00,24315,24315,10494,34809
ΛΑΣΙΘΙΟΥ,1302,187,150,28,337,2021-04-02T00:00:00,9569,9569,6745,16314
ΛΕΣΒΟΥ,1102,151,131,27,282,2021-04-02T00:00:00,7064,7064,4029,11093
ΛΕΥΚΑΔΑΣ,605,53,42,-16,95,2021-04-02T00:00:00,3801,3801,2212,6013
ΛΗΜΝΟΥ,1103,26,46,-8,72,2021-04-02T00:00:00,1969,1969,1258,3227
ΜΑΓΝΗΣΙΑΣ,503,274,251,25,525,2021-04-02T00:00:00,15719,15719,8176,23895
ΜΕΣΣΗΝΙΑΣ,1005,336,125,-17,461,2021-04-02T00:00:00,13622,13622,7714,21336
ΜΗΛΟΥ,1207,82,9,61,91,2021-04-02T00:00:00,1911,1911,452,2363
ΜΥΚΟΝΟΥ,1208,10,2,1,12,2021-04-02T00:00:00,477,477,177,654
ΝΑΞΟΥ,1209,23,25,12,48,2021-04-02T00:00:00,940,940,833,1773
ΝΗΣΩΝ,906,176,187,119,363,2021-04-02T00:00:00,6071,6072,3167,9239
ΝΟΤΙΟΥ ΤΟΜΕΑ ΑΘΗΝΩΝ,907,890,346,-950,1236,2021-04-02T00:00:00,32783,32783,12726,45509
ΞΑΝΘΗΣ,105,135,97,-2,232,2021-04-02T00:00:00,7346,7346,4494,11840
ΠΑΡΟΥ,1210,20,0,-65,20,2021-04-02T00:00:00,848,848,317,1165
ΠΕΙΡΑΙΩΣ,908,557,731,30,1288,2021-04-02T00:00:00,46067,46067,24649,70716
ΠΕΛΛΑΣ,204,106,260,12,366,2021-04-02T00:00:00,13666,13667,8108,21775
ΠΙΕΡΙΑΣ,205,153,183,-30,336,2021-04-02T00:00:00,9946,9946,6064,16010
ΠΡΕΒΕΖΑΣ,404,223,6,-2,229,2021-04-02T00:00:00,6680,6680,1808,8488
ΡΕΘΥΜΝΟΥ,1303,103,140,28,243,2021-04-02T00:00:00,8023,8023,4810,12833
ΡΟΔΟΠΗΣ,106,213,71,-1,284,2021-04-02T00:00:00,7281,7281,3782,11063
ΡΟΔΟΥ,1211,164,131,-15,295,2021-04-02T00:00:00,8802,8802,5069,13871
ΣΑΜΟΥ,1104,53,45,19,98,2021-04-02T00:00:00,2807,2807,1385,4192
ΣΕΡΡΩΝ,206,440,66,34,506,2021-04-02T00:00:00,14241,14241,5789,20030
ΣΠΟΡΑΔΩΝ,504,30,42,36,72,2021-04-02T00:00:00,886,886,476,1362
ΣΥΡΟΥ,1212,41,46,2,87,2021-04-02T00:00:00,2359,2359,1317,3676
ΤΗΝΟΥ,1213,20,4,0,24,2021-04-02T00:00:00,705,705,320,1025
ΤΡΙΚΑΛΩΝ,505,324,102,19,426,2021-04-02T00:00:00,13926,13926,7155,21081
ΦΘΙΩΤΙΔΑΣ,804,452,138,48,590,2021-04-02T00:00:00,12555,12555,6463,19018
ΦΛΩΡΙΝΑΣ,304,65,104,2,169,2021-04-02T00:00:00,5084,5084,3262,8346
ΦΩΚΙΔΑΣ,805,92,20,-31,112,2021-04-02T00:00:00,3066,3066,1552,4618
ΧΑΛΚΙΔΙΚΗΣ,207,179,190,66,369,2021-04-02T00:00:00,9942,9942,5387,15329
ΧΑΝΙΩΝ,1304,190,356,33,546,2021-04-02T00:00:00,17471,17471,10719,28190
ΧΙΟΥ,1105,98,53,-13,151,2021-04-02T00:00:00,5559,5560,2826,8386
ΑΙΤΩΛΟΑΚΑΡΝΑΝΙΑΣ,701,645,117,132,762,2021-04-03T00:00:00,16371,16371,5819,22190
ΑΝΑΤΟΛΙΚΗΣ ΑΤΤΙΚΗΣ,901,929,446,269,1375,2021-04-03T00:00:00,33388,33388,14126,47514
ΑΝΔΡΟΥ,1201,18,0,-17,18,2021-04-03T00:00:00,735,735,309,1044
ΑΡΓΟΛΙΔΑΣ,1001,458,110,272,568,2021-04-03T00:00:00,9546,9546,4662,14208
ΑΡΚΑΔΙΑΣ,1002,205,138,-3,343,2021-04-03T00:00:00,9432,9432,4477,13909
ΑΡΤΑΣ,401,226,51,32,277,2021-04-03T00:00:00,7012,7012,4659,11671
ΑΧΑΪΑΣ,702,664,447,309,1111,2021-04-03T00:00:00,26912,26912,16239,43151
ΒΟΙΩΤΙΑΣ,801,507,111,249,618,2021-04-03T00:00:00,13211,13211,5168,18379
ΒΟΡΕΙΟΥ ΤΟΜΕΑ ΑΘΗΝΩΝ,902,1489,3052,102,4541,2021-04-03T00:00:00,142144,142145,97305,239450
ΓΡΕΒΕΝΩΝ,301,160,54,87,214,2021-04-03T00:00:00,3840,3840,2268,6108
ΔΡΑΜΑΣ,101,228,108,68,336,2021-04-03T00:00:00,8850,8850,5440,14290
ΔΥΤΙΚΗΣ ΑΤΤΙΚΗΣ,903,377,102,187,479,2021-04-03T00:00:00,9942,9942,5406,15348
ΔΥΤΙΚΟΥ ΤΟΜΕΑ ΑΘΗΝΩΝ,904,2108,872,1361,2980,2021-04-03T00:00:00,48021,48021,27047,75068
ΕΒΡΟΥ,102,478,209,215,687,2021-04-03T00:00:00,16301,16301,9315,25616
ΕΥΒΟΙΑΣ,802,722,221,191,943,2021-04-03T00:00:00,19887,19887,11252,31139
ΕΥΡΥΤΑΝΙΑΣ,803,52,36,24,88,2021-04-03T00:00:00,1861,1861,1168,3029
ΖΑΚΥΝΘΟΥ,601,116,54,34,170,2021-04-03T00:00:00,3408,3408,2357,5765
ΗΛΕΙΑΣ,703,448,192,187,640,2021-04-03T00:00:00,12381,12381,6680,19061
ΗΜΑΘΙΑΣ,201,511,92,229,603,2021-04-03T00:00:00,13115,13115,7035,20150
ΗΡΑΚΛΕΙΟΥ,1301,985,328,426,1313,2021-04-03T00:00:00,28309,28309,15935,44244
ΘΑΣΟΥ,103,71,0,21,71,2021-04-03T00:00:00,957,957,457,1414
ΘΕΣΠΡΩΤΙΑΣ,402,252,103,125,355,2021-04-03T00:00:00,6862,6862,3964,10826
ΘΕΣΣΑΛΟΝΙΚΗΣ,202,3943,2271,1906,6214,2021-04-03T00:00:00,127044,127046,79150,206196
ΘΗΡΑΣ,1202,70,35,26,105,2021-04-03T00:00:00,1346,1346,826,2172
ΙΘΑΚΗΣ,602,0,18,-54,18,2021-04-03T00:00:00,837,837,663,1500
ΙΚΑΡΙΑΣ,1101,66,2,21,68,2021-04-03T00:00:00,1618,1618,1144,2762
ΙΩΑΝΝΙΝΩΝ,403,524,224,170,748,2021-04-03T00:00:00,19758,19759,11980,31739
ΚΑΒΑΛΑΣ,104,517,143,247,660,2021-04-03T00:00:00,12096,12096,6966,19062
ΚΑΛΥΜΝΟΥ,1203,118,8,-62,126,2021-04-03T00:00:00,2160,2160,1461,3621
ΚΑΡΔΙΤΣΑΣ,501,275,156,2,431,2021-04-03T00:00:00,14412,14412,6317,20729
ΚΑΡΠΑΘΟΥ,1204,16,2,12,18,2021-04-03T00:00:00,826,826,468,1294
ΚΑΣΤΟΡΙΑΣ,302,242,100,145,342,2021-04-03T00:00:00,6752,6752,3682,10434
ΚΕΑΣ-ΚΥΘΝΟΥ,1205,11,24,11,35,2021-04-03T00:00:00,727,727,138,865
ΚΕΝΤΡΙΚΟΥ ΤΟΜΕΑ ΑΘΗΝΩΝ,905,5072,2207,1933,7279,2021-04-03T00:00:00,161812,161813,93896,255709
ΚΕΡΚΥΡΑΣ,603,354,229,237,583,2021-04-03T00:00:00,10008,10008,5888,15896
ΚΕΦΑΛΛΗΝΙΑΣ,604,124,52,31,176,2021-04-03T00:00:00,4500,4500,2882,7382
ΚΙΛΚΙΣ,203,243,116,110,359,2021-04-03T00:00:00,8588,8588,5877,14465
ΚΟΖΑΝΗΣ,303,607,220,370,827,2021-04-03T00:00:00,14694,14694,7393,22087
ΚΟΡΙΝΘΙΑΣ,1003,428,85,89,513,2021-04-03T00:00:00,12193,12193,4519,16712
ΚΩ,1206,164,118,168,282,2021-04-03T00:00:00,3797,3797,2194,5991
ΛΑΚΩΝΙΑΣ,1004,299,45,131,344,2021-04-03T00:00:00,9153,9153,4540,13693
ΛΑΡΙΣΑΣ,502,856,199,196,1055,2021-04-03T00:00:00,25171,25171,10693,35864
ΛΑΣΙΘΙΟΥ,1302,442,111,216,553,2021-04-03T00:00:00,10011,10011,6856,16867
ΛΕΣΒΟΥ,1102,333,152,203,485,2021-04-03T00:00:00,7397,7397,4181,11578
ΛΕΥΚΑΔΑΣ,605,67,44,16,111,2021-04-03T00:00:00,3868,3868,2256,6124
ΛΗΜΝΟΥ,1103,51,50,29,101,2021-04-03T00:00:00,2020,2020,1308,3328
ΜΑΓΝΗΣΙΑΣ,503,463,235,173,698,2021-04-03T00:00:00,16182,16182,8411,24593
ΜΕΣΣΗΝΙΑΣ,1005,582,114,235,696,2021-04-03T00:00:00,14204,14204,7828,22032
ΜΗΛΟΥ,1207,47,3,-41,50,2021-04-03T00:00:00,1958,1958,455,2413
ΜΥΚΟΝΟΥ,1208,35,1,24,36,2021-04-03T00:00:00,512,512,178,690
ΝΑΞΟΥ,1209,70,26,48,96,2021-04-03T00:00:00,1010,1010,859,1869
ΝΗΣΩΝ,906,248,159,44,407,2021-04-03T00:00:00,6319,6320,3326,9646
ΝΟΤΙΟΥ ΤΟΜΕΑ ΑΘΗΝΩΝ,907,1564,251,579,1815,2021-04-03T00:00:00,34347,34347,12977,47324
ΞΑΝΘΗΣ,105,272,93,133,365,2021-04-03T00:00:00,7618,7618,4587,12205
ΠΑΡΟΥ,1210,91,0,71,91,2021-04-03T00:00:00,939,939,317,1256
ΠΕΙΡΑΙΩΣ,908,882,721,315,1603,2021-04-03T00:00:00,46949,46949,25370,72319
ΠΕΛΛΑΣ,204,414,290,338,704,2021-04-03T00:00:00,14080,14081,8398,22479
ΠΙΕΡΙΑΣ,205,529,222,415,751,2021-04-03T00:00:00,10475,10475,6286,16761
ΠΡΕΒΕΖΑΣ,404,317,7,95,324,2021-04-03T00:00:00,6997,6997,1815,8812
ΡΕΘΥΜΝΟΥ,1303,273,108,138,381,2021-04-03T00:00:00,8296,8296,4918,13214
ΡΟΔΟΠΗΣ,106,313,67,96,380,2021-04-03T00:00:00,7594,7594,3849,11443
ΡΟΔΟΥ,1211,194,203,102,397,2021-04-03T00:00:00,8996,8996,5272,14268
ΣΑΜΟΥ,1104,98,42,42,140,2021-04-03T00:00:00,2905,2905,1427,4332
ΣΕΡΡΩΝ,206,622,59,175,681,2021-04-03T00:00:00,14863,14863,5848,20711
ΣΠΟΡΑΔΩΝ,504,54,6,-12,60,2021-04-03T00:00:00,940,940,482,1422
ΣΥΡΟΥ,1212,37,43,-7,80,2021-04-03T00:00:00,2396,2396,1360,3756
ΤΗΝΟΥ,1213,29,1,6,30,2021-04-03T00:00:00,734,734,321,1055
ΤΡΙΚΑΛΩΝ,505,350,136,60,486,2021-04-03T00:00:00,14276,14276,7291,21567
ΦΘΙΩΤΙΔΑΣ,804,673,136,219,809,2021-04-03T00:00:00,13228,13228,6599,19827
ΦΛΩΡΙΝΑΣ,304,128,112,71,240,2021-04-03T00:00:00,5212,5212,3374,8586
ΦΩΚΙΔΑΣ,805,138,8,34,146,2021-04-03T00:00:00,3204,3204,1560,4764
ΧΑΛΚΙΔΙΚΗΣ,207,291,148,70,439,2021-04-03T00:00:00,10233,10233,5535,15768
ΧΑΝΙΩΝ,1304,539,334,327,873,2021-04-03T00:00:00,18010,18010,11053,29063
ΧΙΟΥ,1105,111,46,6,157,2021-04-03T00:00:00,5670,5671,2872,8543
ΑΙΤΩΛΟΑΚΑΡΝΑΝΙΑΣ,701,0,0,0,0,2020-12-31T00:00:00,0,0,0,0
ΑΝΑΤΟΛΙΚΗΣ ΑΤΤΙΚΗΣ,901,45,0,5,45,2020-12-31T00:00:00,231,231,0,231
ΑΝΔΡΟΥ,1201,0,0,0,0,2020-12-31T00:00:00,0,0,0,0
ΑΡΓΟΛΙΔΑΣ,1001,0,0,0,0,2020-12-31T00:00:00,0,0,0,0
ΑΡΚΑΔΙΑΣ,1002,0,0,0,0,2020-12-31T00:00:00,0,0,0,0
ΑΡΤΑΣ,401,0,0,0,0,2020-12-31T00:00:00,0,0,0,0
ΑΧΑΪΑΣ,702,100,0,3,100,2020-12-31T00:00:00,311,311,0,311
ΒΟΙΩΤΙΑΣ,801,0,0,0,0,2020-12-31T00:00:00,0,0,0,0
ΒΟΡΕΙΟΥ ΤΟΜΕΑ ΑΘΗΝΩΝ,902,0,0,0,0,2020-12-31T00:00:00,0,0,0,0
ΓΡΕΒΕΝΩΝ,301,0,0,0,0,2020-12-31T00:00:00,0,0,0,0
ΔΡΑΜΑΣ,101,0,0,0,0,2020-12-31T00:00:00,0,0,0,0
ΔΥΤΙΚΗΣ ΑΤΤΙΚΗΣ,903,35,0,-14,35,2020-12-31T00:00:00,234,234,0,234
ΔΥΤΙΚΟΥ ΤΟΜΕΑ ΑΘΗΝΩΝ,904,20,0,-20,20,2020-12-31T00:00:00,220,220,0,220
ΕΒΡΟΥ,102,0,0,0,0,2020-12-31T00:00:00,0,0,0,0
ΕΥΒΟΙΑΣ,802,0,0,0,0,2020-12-31T00:00:00,0,0,0,0
ΕΥΡΥΤΑΝΙΑΣ,803,0,0,0,0,2020-12-31T00:00:00,0,0,0,0
ΖΑΚΥΝΘΟΥ,601,0,0,0,0,2020-12-31T00:00:00,0,0,0,0
ΗΛΕΙΑΣ,703,0,0,0,0,2020-12-31T00:00:00,0,0,0,0
ΗΜΑΘΙΑΣ,201,0,0,0,0,2020-12-31T00:00:00,0,0,0,0
ΗΡΑΚΛΕΙΟΥ,1301,0,0,0,0,2020-12-31T00:00:00,0,0,0,0
ΘΑΣΟΥ,103,0,0,0,0,2020-12-31T00:00:00,0,0,0,0
ΘΕΣΠΡΩΤΙΑΣ,402,0,0,0,0,2020-12-31T00:00:00,0,0,0,0
ΘΕΣΣΑΛΟΝΙΚΗΣ,202,80,0,1,80,2020-12-31T00:00:00,217,217,0,217
ΘΗΡΑΣ,1202,0,0,0,0,2020-12-31T00:00:00,0,0,0,0
ΙΘΑΚΗΣ,602,0,0,0,0,2020-12-31T00:00:00,0,0,0,0
ΙΚΑΡΙΑΣ,1101,0,0,0,0,2020-12-31T00:00:00,0,0,0,0
ΙΩΑΝΝΙΝΩΝ,403,101,0,1,101,2020-12-31T00:00:00,278,278,0,278
ΚΑΒΑΛΑΣ,104,0,0,0,0,2020-12-31T00:00:00,0,0,0,0
ΚΑΛΥΜΝΟΥ,1203,0,0,0,0,2020-12-31T00:00:00,0,0,0,0
ΚΑΡΔΙΤΣΑΣ,501,0,0,0,0,2020-12-31T00:00:00,0,0,0,0
ΚΑΡΠΑΘΟΥ,1204,0,0,0,0,2020-12-31T00:00:00,0,0,0,0
ΚΑΣΤΟΡΙΑΣ,302,0,0,0,0,2020-12-31T00:00:00,0,0,0,0
ΚΕΑΣ-ΚΥΘΝΟΥ,1205,0,0,0,0,2020-12-31T00:00:00,0,0,0,0
ΚΕΝΤΡΙΚΟΥ ΤΟΜΕΑ ΑΘΗΝΩΝ,905,120,0,25,120,2020-12-31T00:00:00,482,482,0,482
ΚΕΡΚΥΡΑΣ,603,0,0,0,0,2020-12-31T00:00:00,0,0,0,0
ΚΕΦΑΛΛΗΝΙΑΣ,604,0,0,0,0,2020-12-31T00:00:00,0,0,0,0
ΚΙΛΚΙΣ,203,0,0,0,0,2020-12-31T00:00:00,0,0,0,0
ΚΟΖΑΝΗΣ,303,0,0,0,0,2020-12-31T00:00:00,0,0,0,0
ΚΟΡΙΝΘΙΑΣ,1003,0,0,0,0,2020-12-31T00:00:00,0,0,0,0
ΚΩ,1206,0,0,0,0,2020-12-31T00:00:00,0,0,0,0
ΛΑΚΩΝΙΑΣ,1004,0,0,0,0,2020-12-31T00:00:00,0,0,0,0
ΛΑΡΙΣΑΣ,502,116,0,-29,116,2020-12-31T00:00:00,366,366,0,366
ΛΑΣΙΘΙΟΥ,1302,0,0,0,0,2020-12-31T00:00:00,0,0,0,0
ΛΕΣΒΟΥ,1102,0,0,0,0,2020-12-31T00:00:00,0,0,0,0
ΛΕΥΚΑΔΑΣ,605,0,0,0,0,2020-12-31T00:00:00,0,0,0,0
ΛΗΜΝΟΥ,1103,0,0,0,0,2020-12-31T00:00:00,0,0,0,0
ΜΑΓΝΗΣΙΑΣ,503,0,0,0,0,2020-12-31T00:00:00,0,0,0,0
ΜΕΣΣΗΝΙΑΣ,1005,0,0,0,0,2020-12-31T00:00:00,0,0,0,0
ΜΗΛΟΥ,1207,0,0,0,0,2020-12-31T00:00:00,0,0,0,0
ΜΥΚΟΝΟΥ,1208,0,0,0,0,2020-12-31T00:00:00,0,0,0,0
ΝΑΞΟΥ,1209,0,0,0,0,2020-12-31T00:00:00,0,0,0,0
ΝΗΣΩΝ,906,0,0,0,0,2020-12-31T00:00:00,0,0,0,0
ΝΟΤΙΟΥ ΤΟΜΕΑ ΑΘΗΝΩΝ,907,0,0,0,0,2020-12-31T00:00:00,0,0,0,0
ΞΑΝΘΗΣ,105,0,0,0,0,2020-12-31T00:00:00,0,0,0,0
ΠΑΡΟΥ,1210,0,0,0,0,2020-12-31T00:00:00,0,0,0,0
ΠΕΙΡΑΙΩΣ,908,0,0,0,0,2020-12-31T00:00:00,0,0,0,0
ΠΕΛΛΑΣ,204,0,0,0,0,2020-12-31T00:00:00,0,0,0,0
ΠΙΕΡΙΑΣ,205,0,0,0,0,2020-12-31T00:00:00,0,0,0,0
ΠΡΕΒΕΖΑΣ,404,0,0,0,0,2020-12-31T00:00:00,0,0,0,0
ΡΕΘΥΜΝΟΥ,1303,0,0,0,0,2020-12-31T00:00:00,0,0,0,0
ΡΟΔΟΠΗΣ,106,0,0,0,0,2020-12-31T00:00:00,0,0,0,0
ΡΟΔΟΥ,1211,0,0,0,0,2020-12-31T00:00:00,0,0,0,0
ΣΑΜΟΥ,1104,0,0,0,0,2020-12-31T00:00:00,0,0,0,0
ΣΕΡΡΩΝ,206,0,0,0,0,2020-12-31T00:00:00,0,0,0,0
ΣΠΟΡΑΔΩΝ,504,0,0,0,0,2020-12-31T00:00:00,0,0,0,0
ΣΥΡΟΥ,1212,0,0,0,0,2020-12-31T00:00:00,0,0,0,0
ΤΗΝΟΥ,1213,0,0,0,0,2020-12-31T00:00:00,0,0,0,0
ΤΡΙΚΑΛΩΝ,505,0,0,0,0,2020-12-31T00:00:00,0,0,0,0
ΦΘΙΩΤΙΔΑΣ,804,0,0,0,0,2020-12-31T00:00:00,0,0,0,0
ΦΛΩΡΙΝΑΣ,304,0,0,0,0,2020-12-31T00:00:00,0,0,0,0
ΦΩΚΙΔΑΣ,805,0,0,0,0,2020-12-31T00:00:00,0,0,0,0
ΧΑΛΚΙΔΙΚΗΣ,207,0,0,0,0,2020-12-31T00:00:00,0,0,0,0
ΧΑΝΙΩΝ,1304,0,0,0,0,2020-12-31T00:00:00,0,0,0,0
ΧΙΟΥ,1105,0,0,0,0,2020-12-31T00:00:00,0,0,0,0
ΑΙΤΩΛΟΑΚΑΡΝΑΝΙΑΣ,701,0,0,0,0,2021-01-01T00:00:00,0,0,0,0
ΑΝΑΤΟΛΙΚΗΣ ΑΤΤΙΚΗΣ,901,45,0,0,45,2021-01-01T00:00:00,276,276,0,276
ΑΝΔΡΟΥ,1201,0,0,0,0,2021-01-01T00:00:00,0,0,0,0
ΑΡΓΟΛΙΔΑΣ,1001,0,0,0,0,2021-01-01T00:00:00,0,0,0,0
ΑΡΚΑΔΙΑΣ,1002,0,0,0,0,2021-01-01T00:00:00,0,0,0,0
ΑΡΤΑΣ,401,0,0,0,0,2021-01-01T00:00:00,0,0,0,0
ΑΧΑΪΑΣ,702,0,0,-100,0,2021-01-01T00:00:00,311,311,0,311
ΒΟΙΩΤΙΑΣ,801,0,0,0,0,2021-01-01T00:00:00,0,0,0,0
ΒΟΡΕΙΟΥ ΤΟΜΕΑ ΑΘΗΝΩΝ,902,0,0,0,0,2021-01-01T00:00:00,0,0,0,0
ΓΡΕΒΕΝΩΝ,301,0,0,0,0,2021-01-01T00:00:00,0,0,0,0
ΔΡΑΜΑΣ,101,0,0,0,0,2021-01-01T00:00:00,0,0,0,0
ΔΥΤΙΚΗΣ ΑΤΤΙΚΗΣ,903,0,0,-35,0,2021-01-01T00:00:00,234,234,0,234
ΔΥΤΙΚΟΥ ΤΟΜΕΑ ΑΘΗΝΩΝ,904,30,0,10,30,2021-01-01T00:00:00,250,250,0,250
ΕΒΡΟΥ,102,0,0,0,0,2021-01-01T00:00:00,0,0,0,0
ΕΥΒΟΙΑΣ,802,0,0,0,0,2021-01-01T00:00:00,0,0,0,0
ΕΥΡΥΤΑΝΙΑΣ,803,0,0,0,0,2021-01-01T00:00:00,0,0,0,0
ΖΑΚΥΝΘΟΥ,601,0,0,0,0,2021-01-01T00:00:00,0,0,0,0
ΗΛΕΙΑΣ,703,0,0,0,0,2021-01-01T00:00:00,0,0,0,0
ΗΜΑΘΙΑΣ,201,0,0,0,0,2021-01-01T00:00:00,0,0,0,0
ΗΡΑΚΛΕΙΟΥ,1301,0,0,0,0,2021-01-01T00:00:00,0,0,0,0
ΘΑΣΟΥ,103,0,0,0,0,2021-01-01T00:00:00,0,0,0,0
ΘΕΣΠΡΩΤΙΑΣ,402,0,0,0,0,2021-01-01T00:00:00,0,0,0,0
ΘΕΣΣΑΛΟΝΙΚΗΣ,202,40,0,-40,40,2021-01-01T00:00:00,257,257,0,257
ΘΗΡΑΣ,1202,0,0,0,0,2021-01-01T00:00:00,0,0,0,0
ΙΘΑΚΗΣ,602,0,0,0,0,2021-01-01T00:00:00,0,0,0,0
ΙΚΑΡΙΑΣ,1101,0,0,0,0,2021-01-01T00:00:00,0,0,0,0
ΙΩΑΝΝΙΝΩΝ,403,0,0,-101,0,2021-01-01T00:00:00,278,278,0,278
ΚΑΒΑΛΑΣ,104,0,0,0,0,2021-01-01T00:00:00,0,0,0,0
ΚΑΛΥΜΝΟΥ,1203,0,0,0,0,2021-01-01T00:00:00,0,0,0,0
ΚΑΡΔΙΤΣΑΣ,501,0,0,0,0,2021-01-01T00:00:00,0,0,0,0
ΚΑΡΠΑΘΟΥ,1204,0,0,0,0,2021-01-01T00:00:00,0,0,0,0
ΚΑΣΤΟΡΙΑΣ,302,0,0,0,0,2021-01-01T00:00:00,0,0,0,0
ΚΕΑΣ-ΚΥΘΝΟΥ,1205,0,0,0,0,2021-01-01T00:00:00,0,0,0,0
ΚΕΝΤΡΙΚΟΥ ΤΟΜΕΑ ΑΘΗΝΩΝ,905,89,0,-31,89,2021-01-01T00:00:00,571,571,0,571
ΚΕΡΚΥΡΑΣ,603,0,0,0,0,2021-01-01T00:00:00,0,0,0,0
ΚΕΦΑΛΛΗΝΙΑΣ,604,0,0,0,0,2021-01-01T00:00:00,0,0,0,0
ΚΙΛΚΙΣ,203,0,0,0,0,2021-01-01T00:00:00,0,0,0,0
ΚΟΖΑΝΗΣ,303,0,0,0,0,2021-01-01T00:00:00,0,0,0,0
ΚΟΡΙΝΘΙΑΣ,1003,0,0,0,0,2021-01-01T00:00:00,0,0,0,0
ΚΩ,1206,0,0,0,0,2021-01-01T00:00:00,0,0,0,0
ΛΑΚΩΝΙΑΣ,1004,0,0,0,0,2021-01-01T00:00:00,0,0,0,0
ΛΑΡΙΣΑΣ,502,60,0,-56,60,2021-01-01T00:00:00,426,426,0,426
ΛΑΣΙΘΙΟΥ,1302,0,0,0,0,2021-01-01T00:00:00,0,0,0,0
ΛΕΣΒΟΥ,1102,0,0,0,0,2021-01-01T00:00:00,0,0,0,0
ΛΕΥΚΑΔΑΣ,605,0,0,0,0,2021-01-01T00:00:00,0,0,0,0
ΛΗΜΝΟΥ,1103,0,0,0,0,2021-01-01T00:00:00,0,0,0,0
ΜΑΓΝΗΣΙΑΣ,503,0,0,0,0,2021-01-01T00:00:00,0,0,0,0
ΜΕΣΣΗΝΙΑΣ,1005,0,0,0,0,2021-01-01T00:00:00,0,0,0,0
ΜΗΛΟΥ,1207,0,0,0,0,2021-01-01T00:00:00,0,0,0,0
ΜΥΚΟΝΟΥ,1208,0,0,0,0,2021-01-01T00:00:00,0,0,0,0
ΝΑΞΟΥ,1209,0,0,0,0,2021-01-01T00:00:00,0,0,0,0
ΝΗΣΩΝ,906,0,0,0,0,2021-01-01T00:00:00,0,0,0,0
ΝΟΤΙΟΥ ΤΟΜΕΑ ΑΘΗΝΩΝ,907,0,0,0,0,2021-01-01T00:00:00,0,0,0,0
ΞΑΝΘΗΣ,105,0,0,0,0,2021-01-01T00:00:00,0,0,0,0
ΠΑΡΟΥ,1210,0,0,0,0,2021-01-01T00:00:00,0,0,0,0
ΠΕΙΡΑΙΩΣ,908,0,0,0,0,2021-01-01T00:00:00,0,0,0,0
ΠΕΛΛΑΣ,204,0,0,0,0,2021-01-01T00:00:00,0,0,0,0
ΠΙΕΡΙΑΣ,205,0,0,0,0,2021-01-01T00:00:00,0,0,0,0
ΠΡΕΒΕΖΑΣ,404,0,0,0,0,2021-01-01T00:00:00,0,0,0,0
ΡΕΘΥΜΝΟΥ,1303,0,0,0,0,2021-01-01T00:00:00,0,0,0,0
ΡΟΔΟΠΗΣ,106,0,0,0,0,2021-01-01T00:00:00,0,0,0,0
ΡΟΔΟΥ,1211,0,0,0,0,2021-01-01T00:00:00,0,0,0,0
ΣΑΜΟΥ,1104,0,0,0,0,2021-01-01T00:00:00,0,0,0,0
ΣΕΡΡΩΝ,206,0,0,0,0,2021-01-01T00:00:00,0,0,0,0
ΣΠΟΡΑΔΩΝ,504,0,0,0,0,2021-01-01T00:00:00,0,0,0,0
ΣΥΡΟΥ,1212,0,0,0,0,2021-01-01T00:00:00,0,0,0,0
ΤΗΝΟΥ,1213,0,0,0,0,2021-01-01T00:00:00,0,0,0,0
ΤΡΙΚΑΛΩΝ,505,0,0,0,0,2021-01-01T00:00:00,0,0,0,0
ΦΘΙΩΤΙΔΑΣ,804,0,0,0,0,2021-01-01T00:00:00,0,0,0,0
ΦΛΩΡΙΝΑΣ,304,0,0,0,0,2021-01-01T00:00:00,0,0,0,0
ΦΩΚΙΔΑΣ,805,0,0,0,0,2021-01-01T00:00:00,0,0,0,0
ΧΑΛΚΙΔΙΚΗΣ,207,0,0,0,0,2021-01-01T00:00:00,0,0,0,0
ΧΑΝΙΩΝ,1304,0,0,0,0,2021-01-01T00:00:00,0,0,0,0
ΧΙΟΥ,1105,0,0,0,0,2021-01-01T00:00:00,0,0,0,0
ΑΙΤΩΛΟΑΚΑΡΝΑΝΙΑΣ,701,0,0,0,0,2021-01-02T00:00:00,0,0,0,0
ΑΝΑΤΟΛΙΚΗΣ ΑΤΤΙΚΗΣ,901,50,0,5,50,2021-01-02T00:00:00,326,326,0,326
ΑΝΔΡΟΥ,1201,0,0,0,0,2021-01-02T00:00:00,0,0,0,0
ΑΡΓΟΛΙΔΑΣ,1001,0,0,0,0,2021-01-02T00:00:00,0,0,0,0
ΑΡΚΑΔΙΑΣ,1002,0,0,0,0,2021-01-02T00:00:00,0,0,0,0
ΑΡΤΑΣ,401,0,0,0,0,2021-01-02T00:00:00,0,0,0,0
ΑΧΑΪΑΣ,702,105,0,105,105,2021-01-02T00:00:00,416,416,0,416
ΒΟΙΩΤΙΑΣ,801,0,0,0,0,2021-01-02T00:00:00,0,0,0,0
ΒΟΡΕΙΟΥ ΤΟΜΕΑ ΑΘΗΝΩΝ,902,0,0,0,0,2021-01-02T00:00:00,0,0,0,0
ΓΡΕΒΕΝΩΝ,301,0,0,0,0,2021-01-02T00:00:00,0,0,0,0
ΔΡΑΜΑΣ,101,0,0,0,0,2021-01-02T00:00:00,0,0,0,0
ΔΥΤΙΚΗΣ ΑΤΤΙΚΗΣ,903,0,0,0,0,2021-01-02T00:00:00,234,234,0,234
ΔΥΤΙΚΟΥ ΤΟΜΕΑ ΑΘΗΝΩΝ,904,65,0,35,65,2021-01-02T00:00:00,315,315,0,315
ΕΒΡΟΥ,102,0,0,0,0,2021-01-02T00:00:00,0,0,0,0
ΕΥΒΟΙΑΣ,802,0,0,0,0,2021-01-02T00:00:00,0,0,0,0
ΕΥΡΥΤΑΝΙΑΣ,803,0,0,0,0,2021-01-02T00:00:00,0,0,0,0
ΖΑΚΥΝΘΟΥ,601,0,0,0,0,2021-01-02T00:00:00,0,0,0,0
ΗΛΕΙΑΣ,703,0,0,0,0,2021-01-02T00:00:00,0,0,0,0
ΗΜΑΘΙΑΣ,201,0,0,0,0,2021-01-02T00:00:00,0,0,0,0
ΗΡΑΚΛΕΙΟΥ,1301,0,0,0,0,2021-01-02T00:00:00,0,0,0,0
ΘΑΣΟΥ,103,0,0,0,0,2021-01-02T00:00:00,0,0,0,0
ΘΕΣΠΡΩΤΙΑΣ,402,0,0,0,0,2021-01-02T00:00:00,0,0,0,0
ΘΕΣΣΑΛΟΝΙΚΗΣ,202,81,0,41,81,2021-01-02T00:00:00,338,338,0,338
ΘΗΡΑΣ,1202,0,0,0,0,2021-01-02T00:00:00,0,0,0,0
ΙΘΑΚΗΣ,602,0,0,0,0,2021-01-02T00:00:00,0,0,0,0
ΙΚΑΡΙΑΣ,1101,0,0,0,0,2021-01-02T00:00:00,0,0,0,0
ΙΩΑΝΝΙΝΩΝ,403,70,0,70,70,2021-01-02T00:00:00,348,348,0,348
ΚΑΒΑΛΑΣ,104,0,0,0,0,2021-01-02T00:00:00,0,0,0,0
ΚΑΛΥΜΝΟΥ,1203,0,0,0,0,2021-01-02T00:00:00,0,0,0,0
ΚΑΡΔΙΤΣΑΣ,501,0,0,0,0,2021-01-02T00:00:00,0,0,0,0
ΚΑΡΠΑΘΟΥ,1204,0,0,0,0,2021-01-02T00:00:00,0,0,0,0
ΚΑΣΤΟΡΙΑΣ,302,0,0,0,0,2021-01-02T00:00:00,0,0,0,0
ΚΕΑΣ-ΚΥΘΝΟΥ,1205,0,0,0,0,2021-01-02T00:00:00,0,0,0,0
ΚΕΝΤΡΙΚΟΥ ΤΟΜΕΑ ΑΘΗΝΩΝ,905,130,0,41,130,2021-01-02T00:00:00,701,701,0,701
ΚΕΡΚΥΡΑΣ,603,0,0,0,0,2021-01-02T00:00:00,0,0,0,0
ΚΕΦΑΛΛΗΝΙΑΣ,604,0,0,0,0,2021-01-02T00:00:00,0,0,0,0
ΚΙΛΚΙΣ,203,0,0,0,0,2021-01-02T00:00:00,0,0,0,0
ΚΟΖΑΝΗΣ,303,0,0,0,0,2021-01-02T00:00:00,0,0,0,0
ΚΟΡΙΝΘΙΑΣ,1003,0,0,0,0,2021-01-02T00:00:00,0,0,0,0
ΚΩ,1206,0,0,0,0,2021-01-02T00:00:00,0,0,0,0
ΛΑΚΩΝΙΑΣ,1004,0,0,0,0,2021-01-02T00:00:00,0,0,0,0
ΛΑΡΙΣΑΣ,502,45,0,-15,45,2021-01-02T00:00:00,471,471,0,471
ΛΑΣΙΘΙΟΥ,1302,0,0,0,0,2021-01-02T00:00:00,0,0,0,0
ΛΕΣΒΟΥ,1102,0,0,0,0,2021-01-02T00:00:00,0,0,0,0
ΛΕΥΚΑΔΑΣ,605,0,0,0,0,2021-01-02T00:00:00,0,0,0,0
ΛΗΜΝΟΥ,1103,0,0,0,0,2021-01-02T00:00:00,0,0,0,0
ΜΑΓΝΗΣΙΑΣ,503,0,0,0,0,2021-01-02T00:00:00,0,0,0,0
ΜΕΣΣΗΝΙΑΣ,1005,0,0,0,0,2021-01-02T00:00:00,0,0,0,0
ΜΗΛΟΥ,1207,0,0,0,0,2021-01-02T00:00:00,0,0,0,0
ΜΥΚΟΝΟΥ,1208,0,0,0,0,2021-01-02T00:00:00,0,0,0,0
ΝΑΞΟΥ,1209,0,0,0,0,2021-01-02T00:00:00,0,0,0,0
ΝΗΣΩΝ,906,0,0,0,0,2021-01-02T00:00:00,0,0,0,0
ΝΟΤΙΟΥ ΤΟΜΕΑ ΑΘΗΝΩΝ,907,0,0,0,0,2021-01-02T00:00:00,0,0,0,0
ΞΑΝΘΗΣ,105,0,0,0,0,2021-01-02T00:00:00,0,0,0,0
ΠΑΡΟΥ,1210,0,0,0,0,2021-01-02T00:00:00,0,0,0,0
ΠΕΙΡΑΙΩΣ,908,0,0,0,0,2021-01-02T00:00:00,0,0,0,0
ΠΕΛΛΑΣ,204,0,0,0,0,2021-01-02T00:00:00,0,0,0,0
ΠΙΕΡΙΑΣ,205,0,0,0,0,2021-01-02T00:00:00,0,0,0,0
ΠΡΕΒΕΖΑΣ,404,0,0,0,0,2021-01-02T00:00:00,0,0,0,0
ΡΕΘΥΜΝΟΥ,1303,0,0,0,0,2021-01-02T00:00:00,0,0,0,0
ΡΟΔΟΠΗΣ,106,0,0,0,0,2021-01-02T00:00:00,0,0,0,0
ΡΟΔΟΥ,1211,0,0,0,0,2021-01-02T00:00:00,0,0,0,0
ΣΑΜΟΥ,1104,0,0,0,0,2021-01-02T00:00:00,0,0,0,0
ΣΕΡΡΩΝ,206,0,0,0,0,2021-01-02T00:00:00,0,0,0,0
ΣΠΟΡΑΔΩΝ,504,0,0,0,0,2021-01-02T00:00:00,0,0,0,0
ΣΥΡΟΥ,1212,0,0,0,0,2021-01-02T00:00:00,0,0,0,0
ΤΗΝΟΥ,1213,0,0,0,0,2021-01-02T00:00:00,0,0,0,0
ΤΡΙΚΑΛΩΝ,505,0,0,0,0,2021-01-02T00:00:00,0,0,0,0
ΦΘΙΩΤΙΔΑΣ,804,0,0,0,0,2021-01-02T00:00:00,0,0,0,0
ΦΛΩΡΙΝΑΣ,304,0,0,0,0,2021-01-02T00:00:00,0,0,0,0
ΦΩΚΙΔΑΣ,805,0,0,0,0,2021-01-02T00:00:00,0,0,0,0
ΧΑΛΚΙΔΙΚΗΣ,207,0,0,0,0,2021-01-02T00:00:00,0,0,0,0
ΧΑΝΙΩΝ,1304,0,0,0,0,2021-01-02T00:00:00,0,0,0,0
ΧΙΟΥ,1105,0,0,0,0,2021-01-02T00:00:00,0,0,0,0
ΑΙΤΩΛΟΑΚΑΡΝΑΝΙΑΣ,701,0,0,0,0,2021-01-03T00:00:00,0,0,0,0
ΑΝΑΤΟΛΙΚΗΣ ΑΤΤΙΚΗΣ,901,55,0,5,55,2021-01-03T00:00:00,381,381,0,381
ΑΝΔΡΟΥ,1201,0,0,0,0,2021-01-03T00:00:00,0,0,0,0
ΑΡΓΟΛΙΔΑΣ,1001,0,0,0,0,2021-01-03T00:00:00,0,0,0,0
ΑΡΚΑΔΙΑΣ,1002,0,0,0,0,2021-01-03T00:00:00,0,0,0,0
ΑΡΤΑΣ,401,20,0,20,20,2021-01-03T00:00:00,20,20,0,20
ΑΧΑΪΑΣ,702,150,0,45,150,2021-01-03T00:00:00,566,566,0,566
ΒΟΙΩΤΙΑΣ,801,0,0,0,0,2021-01-03T00:00:00,0,0,0,0
ΒΟΡΕΙΟΥ ΤΟΜΕΑ ΑΘΗΝΩΝ,902,18,0,18,18,2021-01-03T00:00:00,18,18,0,18
ΓΡΕΒΕΝΩΝ,301,0,0,0,0,2021-01-03T00:00:00,0,0,0,0
ΔΡΑΜΑΣ,101,0,0,0,0,2021-01-03T00:00:00,0,0,0,0
ΔΥΤΙΚΗΣ ΑΤΤΙΚΗΣ,903,0,0,0,0,2021-01-03T00:00:00,234,234,0,234
ΔΥΤΙΚΟΥ ΤΟΜΕΑ ΑΘΗΝΩΝ,904,70,0,5,70,2021-01-03T00:00:00,385,385,0,385
ΕΒΡΟΥ,102,0,0,0,0,2021-01-03T00:00:00,0,0,0,0
ΕΥΒΟΙΑΣ,802,0,0,0,0,2021-01-03T00:00:00,0,0,0,0
ΕΥΡΥΤΑΝΙΑΣ,803,0,0,0,0,2021-01-03T00:00:00,0,0,0,0
ΖΑΚΥΝΘΟΥ,601,0,0,0,0,2021-01-03T00:00:00,0,0,0,0
ΗΛΕΙΑΣ,703,0,0,0,0,2021-01-03T00:00:00,0,0,0,0
ΗΜΑΘΙΑΣ,201,0,0,0,0,2021-01-03T00:00:00,0,0,0,0
ΗΡΑΚΛΕΙΟΥ,1301,0,0,0,0,2021-01-03T00:00:00,0,0,0,0
ΘΑΣΟΥ,103,0,0,0,0,2021-01-03T00:00:00,0,0,0,0
ΘΕΣΠΡΩΤΙΑΣ,402,0,0,0,0,2021-01-03T00:00:00,0,0,0,0
ΘΕΣΣΑΛΟΝΙΚΗΣ,202,123,0,42,123,2021-01-03T00:00:00,461,461,0,461
ΘΗΡΑΣ,1202,0,0,0,0,2021-01-03T00:00:00,0,0,0,0
ΙΘΑΚΗΣ,602,0,0,0,0,2021-01-03T00:00:00,0,0,0,0
ΙΚΑΡΙΑΣ,1101,0,0,0,0,2021-01-03T00:00:00,0,0,0,0
ΙΩΑΝΝΙΝΩΝ,403,80,0,10,80,2021-01-03T00:00:00,428,428,0,428
ΚΑΒΑΛΑΣ,104,0,0,0,0,2021-01-03T00:00:00,0,0,0,0
ΚΑΛΥΜΝΟΥ,1203,0,0,0,0,2021-01-03T00:00:00,0,0,0,0
ΚΑΡΔΙΤΣΑΣ,501,0,0,0,0,2021-01-03T00:00:00,0,0,0,0
ΚΑΡΠΑΘΟΥ,1204,0,0,0,0,2021-01-03T00:00:00,0,0,0,0
ΚΑΣΤΟΡΙΑΣ,302,0,0,0,0,2021-01-03T00:00:00,0,0,0,0
ΚΕΑΣ-ΚΥΘΝΟΥ,1205,0,0,0,0,2021-01-03T00:00:00,0,0,0,0
ΚΕΝΤΡΙΚΟΥ ΤΟΜΕΑ ΑΘΗΝΩΝ,905,166,0,36,166,2021-01-03T00:00:00,867,867,0,867
ΚΕΡΚΥΡΑΣ,603,0,0,0,0,2021-01-03T00:00:00,0,0,0,0
ΚΕΦΑΛΛΗΝΙΑΣ,604,0,0,0,0,2021-01-03T00:00:00,0,0,0,0
ΚΙΛΚΙΣ,203,0,0,0,0,2021-01-03T00:00:00,0,0,0,0
ΚΟΖΑΝΗΣ,303,0,0,0,0,2021-01-03T00:00:00,0,0,0,0
ΚΟΡΙΝΘΙΑΣ,1003,0,0,0,0,2021-01-03T00:00:00,0,0,0,0
ΚΩ,1206,0,0,0,0,2021-01-03T00:00:00,0,0,0,0
ΛΑΚΩΝΙΑΣ,1004,0,0,0,0,2021-01-03T00:00:00,0,0,0,0
ΛΑΡΙΣΑΣ,502,35,0,-10,35,2021-01-03T00:00:00,506,506,0,506
ΛΑΣΙΘΙΟΥ,1302,0,0,0,0,2021-01-03T00:00:00,0,0,0,0
ΛΕΣΒΟΥ,1102,0,0,0,0,2021-01-03T00:00:00,0,0,0,0
ΛΕΥΚΑΔΑΣ,605,0,0,0,0,2021-01-03T00:00:00,0,0,0,0
ΛΗΜΝΟΥ,1103,0,0,0,0,2021-01-03T00:00:00,0,0,0,0
ΜΑΓΝΗΣΙΑΣ,503,0,0,0,0,2021-01-03T00:00:00,0,0,0,0
ΜΕΣΣΗΝΙΑΣ,1005,0,0,0,0,2021-01-03T00:00:00,0,0,0,0
ΜΗΛΟΥ,1207,0,0,0,0,2021-01-03T00:00:00,0,0,0,0
ΜΥΚΟΝΟΥ,1208,0,0,0,0,2021-01-03T00:00:00,0,0,0,0
ΝΑΞΟΥ,1209,0,0,0,0,2021-01-03T00:00:00,0,0,0,0
ΝΗΣΩΝ,906,0,0,0,0,2021-01-03T00:00:00,0,0,0,0
ΝΟΤΙΟΥ ΤΟΜΕΑ ΑΘΗΝΩΝ,907,0,0,0,0,2021-01-03T00:00:00,0,0,0,0
ΞΑΝΘΗΣ,105,0,0,0,0,2021-01-03T00:00:00,0,0,0,0
ΠΑΡΟΥ,1210,0,0,0,0,2021-01-03T00:00:00,0,0,0,0
ΠΕΙΡΑΙΩΣ,908,3,0,3,3,2021-01-03T00:00:00,3,3,0,3
ΠΕΛΛΑΣ,204,0,0,0,0,2021-01-03T00:00:00,0,0,0,0
ΠΙΕΡΙΑΣ,205,0,0,0,0,2021-01-03T00:00:00,0,0,0,0
ΠΡΕΒΕΖΑΣ,404,0,0,0,0,2021-01-03T00:00:00,0,0,0,0
ΡΕΘΥΜΝΟΥ,1303,0,0,0,0,2021-01-03T00:00:00,0,0,0,0
ΡΟΔΟΠΗΣ,106,0,0,0,0,2021-01-03T00:00:00,0,0,0,0
ΡΟΔΟΥ,1211,0,0,0,0,2021-01-03T00:00:00,0,0,0,0
ΣΑΜΟΥ,1104,0,0,0,0,2021-01-03T00:00:00,0,0,0,0
ΣΕΡΡΩΝ,206,0,0,0,0,2021-01-03T00:00:00,0,0,0,0
ΣΠΟΡΑΔΩΝ,504,0,0,0,0,2021-01-03T00:00:00,0,0,0,0
ΣΥΡΟΥ,1212,0,0,0,0,2021-01-03T00:00:00,0,0,0,0
ΤΗΝΟΥ,1213,0,0,0,0,2021-01-03T00:00:00,0,0,0,0
ΤΡΙΚΑΛΩΝ,505,0,0,0,0,2021-01-03T00:00:00,0,0,0,0
ΦΘΙΩΤΙΔΑΣ,804,0,0,0,0,2021-01-03T00:00:00,0,0,0,0
ΦΛΩΡΙΝΑΣ,304,0,0,0,0,2021-01-03T00:00:00,0,0,0,0
ΦΩΚΙΔΑΣ,805,0,0,0,0,2021-01-03T00:00:00,0,0,0,0
ΧΑΛΚΙΔΙΚΗΣ,207,0,0,0,0,2021-01-03T00:00:00,0,0,0,0
ΧΑΝΙΩΝ,1304,0,0,0,0,2021-01-03T00:00:00,0,0,0,0
ΧΙΟΥ,1105,0,0,0,0,2021-01-03T00:00:00,0,0,0,0
ΑΙΤΩΛΟΑΚΑΡΝΑΝΙΑΣ,701,50,0,50,50,2021-01-04T00:00:00,50,50,0,50
ΑΝΑΤΟΛΙΚΗΣ ΑΤΤΙΚΗΣ,901,85,0,30,85,2021-01-04T00:00:00,466,466,0,466
ΑΝΔΡΟΥ,1201,0,0,0,0,2021-01-04T00:00:00,0,0,0,0
ΑΡΓΟΛΙΔΑΣ,1001,0,0,0,0,2021-01-04T00:00:00,0,0,0,0
ΑΡΚΑΔΙΑΣ,1002,0,0,0,0,2021-01-04T00:00:00,0,0,0,0
ΑΡΤΑΣ,401,60,0,40,60,2021-01-04T00:00:00,80,80,0,80
ΑΧΑΪΑΣ,702,270,0,120,270,2021-01-04T00:00:00,836,836,0,836
ΒΟΙΩΤΙΑΣ,801,0,0,0,0,2021-01-04T00:00:00,0,0,0,0
ΒΟΡΕΙΟΥ ΤΟΜΕΑ ΑΘΗΝΩΝ,902,664,0,646,664,2021-01-04T00:00:00,682,682,0,682
ΓΡΕΒΕΝΩΝ,301,0,0,0,0,2021-01-04T00:00:00,0,0,0,0
ΔΡΑΜΑΣ,101,0,0,0,0,2021-01-04T00:00:00,0,0,0,0
ΔΥΤΙΚΗΣ ΑΤΤΙΚΗΣ,903,65,0,65,65,2021-01-04T00:00:00,299,299,0,299
ΔΥΤΙΚΟΥ ΤΟΜΕΑ ΑΘΗΝΩΝ,904,150,0,80,150,2021-01-04T00:00:00,535,535,0,535
ΕΒΡΟΥ,102,0,0,0,0,2021-01-04T00:00:00,0,0,0,0
ΕΥΒΟΙΑΣ,802,0,0,0,0,2021-01-04T00:00:00,0,0,0,0
ΕΥΡΥΤΑΝΙΑΣ,803,0,0,0,0,2021-01-04T00:00:00,0,0,0,0
ΖΑΚΥΝΘΟΥ,601,0,0,0,0,2021-01-04T00:00:00,0,0,0,0
ΗΛΕΙΑΣ,703,0,0,0,0,2021-01-04T00:00:00,0,0,0,0
ΗΜΑΘΙΑΣ,201,79,0,79,79,2021-01-04T00:00:00,79,79,0,79
ΗΡΑΚΛΕΙΟΥ,1301,131,0,131,131,2021-01-04T00:00:00,131,131,0,131
ΘΑΣΟΥ,103,0,0,0,0,2021-01-04T00:00:00,0,0,0,0
ΘΕΣΠΡΩΤΙΑΣ,402,0,0,0,0,2021-01-04T00:00:00,0,0,0,0
ΘΕΣΣΑΛΟΝΙΚΗΣ,202,1181,0,1058,1181,2021-01-04T00:00:00,1642,1642,0,1642
ΘΗΡΑΣ,1202,0,0,0,0,2021-01-04T00:00:00,0,0,0,0
ΙΘΑΚΗΣ,602,0,0,0,0,2021-01-04T00:00:00,0,0,0,0
ΙΚΑΡΙΑΣ,1101,0,0,0,0,2021-01-04T00:00:00,0,0,0,0
ΙΩΑΝΝΙΝΩΝ,403,259,0,179,259,2021-01-04T00:00:00,687,687,0,687
ΚΑΒΑΛΑΣ,104,0,0,0,0,2021-01-04T00:00:00,0,0,0,0
ΚΑΛΥΜΝΟΥ,1203,0,0,0,0,2021-01-04T00:00:00,0,0,0,0
ΚΑΡΔΙΤΣΑΣ,501,100,0,100,100,2021-01-04T00:00:00,100,100,0,100
ΚΑΡΠΑΘΟΥ,1204,0,0,0,0,2021-01-04T00:00:00,0,0,0,0
ΚΑΣΤΟΡΙΑΣ,302,0,0,0,0,2021-01-04T00:00:00,0,0,0,0
ΚΕΑΣ-ΚΥΘΝΟΥ,1205,0,0,0,0,2021-01-04T00:00:00,0,0,0,0
ΚΕΝΤΡΙΚΟΥ ΤΟΜΕΑ ΑΘΗΝΩΝ,905,2254,0,2088,2254,2021-01-04T00:00:00,3121,3121,0,3121
ΚΕΡΚΥΡΑΣ,603,0,0,0,0,2021-01-04T00:00:00,0,0,0,0
ΚΕΦΑΛΛΗΝΙΑΣ,604,0,0,0,0,2021-01-04T00:00:00,0,0,0,0
ΚΙΛΚΙΣ,203,0,0,0,0,2021-01-04T00:00:00,0,0,0,0
ΚΟΖΑΝΗΣ,303,124,0,124,124,2021-01-04T00:00:00,124,124,0,124
ΚΟΡΙΝΘΙΑΣ,1003,50,0,50,50,2021-01-04T00:00:00,50,50,0,50
ΚΩ,1206,0,0,0,0,2021-01-04T00:00:00,0,0,0,0
ΛΑΚΩΝΙΑΣ,1004,0,0,0,0,2021-01-04T00:00:00,0,0,0,0
ΛΑΡΙΣΑΣ,502,230,0,195,230,2021-01-04T00:00:00,736,736,0,736
ΛΑΣΙΘΙΟΥ,1302,0,0,0,0,2021-01-04T00:00:00,0,0,0,0
ΛΕΣΒΟΥ,1102,0,0,0,0,2021-01-04T00:00:00,0,0,0,0
ΛΕΥΚΑΔΑΣ,605,0,0,0,0,2021-01-04T00:00:00,0,0,0,0
ΛΗΜΝΟΥ,1103,0,0,0,0,2021-01-04T00:00:00,0,0,0,0
ΜΑΓΝΗΣΙΑΣ,503,0,0,0,0,2021-01-04T00:00:00,0,0,0,0
ΜΕΣΣΗΝΙΑΣ,1005,0,0,0,0,2021-01-04T00:00:00,0,0,0,0
ΜΗΛΟΥ,1207,0,0,0,0,2021-01-04T00:00:00,0,0,0,0
ΜΥΚΟΝΟΥ,1208,0,0,0,0,2021-01-04T00:00:00,0,0,0,0
ΝΑΞΟΥ,1209,0,0,0,0,2021-01-04T00:00:00,0,0,0,0
ΝΗΣΩΝ,906,0,0,0,0,2021-01-04T00:00:00,0,0,0,0
ΝΟΤΙΟΥ ΤΟΜΕΑ ΑΘΗΝΩΝ,907,0,0,0,0,2021-01-04T00:00:00,0,0,0,0
ΞΑΝΘΗΣ,105,0,0,0,0,2021-01-04T00:00:00,0,0,0,0
ΠΑΡΟΥ,1210,0,0,0,0,2021-01-04T00:00:00,0,0,0,0
ΠΕΙΡΑΙΩΣ,908,176,0,173,176,2021-01-04T00:00:00,179,179,0,179
ΠΕΛΛΑΣ,204,146,0,146,146,2021-01-04T00:00:00,146,146,0,146
ΠΙΕΡΙΑΣ,205,94,0,94,94,2021-01-04T00:00:00,94,94,0,94
ΠΡΕΒΕΖΑΣ,404,0,0,0,0,2021-01-04T00:00:00,0,0,0,0
ΡΕΘΥΜΝΟΥ,1303,0,0,0,0,2021-01-04T00:00:00,0,0,0,0
ΡΟΔΟΠΗΣ,106,0,0,0,0,2021-01-04T00:00:00,0,0,0,0
ΡΟΔΟΥ,1211,0,0,0,0,2021-01-04T00:00:00,0,0,0,0
ΣΑΜΟΥ,1104,0,0,0,0,2021-01-04T00:00:00,0,0,0,0
ΣΕΡΡΩΝ,206,0,0,0,0,2021-01-04T00:00:00,0,0,0,0
ΣΠΟΡΑΔΩΝ,504,0,0,0,0,2021-01-04T00:00:00,0,0,0,0
ΣΥΡΟΥ,1212,0,0,0,0,2021-01-04T00:00:00,0,0,0,0
ΤΗΝΟΥ,1213,0,0,0,0,2021-01-04T00:00:00,0,0,0,0
ΤΡΙΚΑΛΩΝ,505,140,0,140,140,2021-01-04T00:00:00,140,140,0,140
ΦΘΙΩΤΙΔΑΣ,804,0,0,0,0,2021-01-04T00:00:00,0,0,0,0
ΦΛΩΡΙΝΑΣ,304,0,0,0,0,2021-01-04T00:00:00,0,0,0,0
ΦΩΚΙΔΑΣ,805,0,0,0,0,2021-01-04T00:00:00,0,0,0,0
ΧΑΛΚΙΔΙΚΗΣ,207,0,0,0,0,2021-01-04T00:00:00,0,0,0,0
ΧΑΝΙΩΝ,1304,150,0,150,150,2021-01-04T00:00:00,150,150,0,150
ΧΙΟΥ,1105,0,0,0,0,2021-01-04T00:00:00,0,0,0,0
ΑΙΤΩΛΟΑΚΑΡΝΑΝΙΑΣ,701,50,0,0,50,2021-01-05T00:00:00,100,100,0,100
ΑΝΑΤΟΛΙΚΗΣ ΑΤΤΙΚΗΣ,901,40,0,-45,40,2021-01-05T00:00:00,506,506,0,506
ΑΝΔΡΟΥ,1201,0,0,0,0,2021-01-05T00:00:00,0,0,0,0
ΑΡΓΟΛΙΔΑΣ,1001,0,0,0,0,2021-01-05T00:00:00,0,0,0,0
ΑΡΚΑΔΙΑΣ,1002,0,0,0,0,2021-01-05T00:00:00,0,0,0,0
ΑΡΤΑΣ,401,95,0,35,95,2021-01-05T00:00:00,175,175,0,175
ΑΧΑΪΑΣ,702,380,0,110,380,2021-01-05T00:00:00,1216,1216,0,1216
ΒΟΙΩΤΙΑΣ,801,0,0,0,0,2021-01-05T00:00:00,0,0,0,0
ΒΟΡΕΙΟΥ ΤΟΜΕΑ ΑΘΗΝΩΝ,902,637,0,-27,637,2021-01-05T00:00:00,1319,1319,0,1319
ΓΡΕΒΕΝΩΝ,301,0,0,0,0,2021-01-05T00:00:00,0,0,0,0
ΔΡΑΜΑΣ,101,0,0,0,0,2021-01-05T00:00:00,0,0,0,0
ΔΥΤΙΚΗΣ ΑΤΤΙΚΗΣ,903,40,0,-25,40,2021-01-05T00:00:00,339,339,0,339
ΔΥΤΙΚΟΥ ΤΟΜΕΑ ΑΘΗΝΩΝ,904,150,0,0,150,2021-01-05T00:00:00,685,685,0,685
ΕΒΡΟΥ,102,0,0,0,0,2021-01-05T00:00:00,0,0,0,0
ΕΥΒΟΙΑΣ,802,0,0,0,0,2021-01-05T00:00:00,0,0,0,0
ΕΥΡΥΤΑΝΙΑΣ,803,0,0,0,0,2021-01-05T00:00:00,0,0,0,0
ΖΑΚΥΝΘΟΥ,601,0,0,0,0,2021-01-05T00:00:00,0,0,0,0
ΗΛΕΙΑΣ,703,0,0,0,0,2021-01-05T00:00:00,0,0,0,0
ΗΜΑΘΙΑΣ,201,50,0,-29,50,2021-01-05T00:00:00,129,129,0,129
ΗΡΑΚΛΕΙΟΥ,1301,125,0,-6,125,2021-01-05T00:00:00,256,256,0,256
ΘΑΣΟΥ,103,0,0,0,0,2021-01-05T00:00:00,0,0,0,0
ΘΕΣΠΡΩΤΙΑΣ,402,0,0,0,0,2021-01-05T00:00:00,0,0,0,0
ΘΕΣΣΑΛΟΝΙΚΗΣ,202,1266,0,85,1266,2021-01-05T00:00:00,2908,2908,0,2908
ΘΗΡΑΣ,1202,0,0,0,0,2021-01-05T00:00:00,0,0,0,0
ΙΘΑΚΗΣ,602,0,0,0,0,2021-01-05T00:00:00,0,0,0,0
ΙΚΑΡΙΑΣ,1101,0,0,0,0,2021-01-05T00:00:00,0,0,0,0
ΙΩΑΝΝΙΝΩΝ,403,216,0,-43,216,2021-01-05T00:00:00,903,903,0,903
ΚΑΒΑΛΑΣ,104,0,0,0,0,2021-01-05T00:00:00,0,0,0,0
ΚΑΛΥΜΝΟΥ,1203,0,0,0,0,2021-01-05T00:00:00,0,0,0,0
ΚΑΡΔΙΤΣΑΣ,501,140,0,40,140,2021-01-05T00:00:00,240,240,0,240
ΚΑΡΠΑΘΟΥ,1204,0,0,0,0,2021-01-05T00:00:00,0,0,0,0
ΚΑΣΤΟΡΙΑΣ,302,0,0,0,0,2021-01-05T00:00:00,0,0,0,0
ΚΕΑΣ-ΚΥΘΝΟΥ,1205,0,0,0,0,2021-01-05T00:00:00,0,0,0,0
ΚΕΝΤΡΙΚΟΥ ΤΟΜΕΑ ΑΘΗΝΩΝ,905,2208,0,-46,2208,2021-01-05T00:00:00,5329,5329,0,5329
ΚΕΡΚΥΡΑΣ,603,0,0,0,0,2021-01-05T00:00:00,0,0,0,0
ΚΕΦΑΛΛΗΝΙΑΣ,604,0,0,0,0,2021-01-05T00:00:00,0,0,0,0
ΚΙΛΚΙΣ,203,0,0,0,0,2021-01-05T00:00:00,0,0,0,0
ΚΟΖΑΝΗΣ,303,104,0,-20,104,2021-01-05T00:00:00,228,228,0,228
ΚΟΡΙΝΘΙΑΣ,1003,50,0,0,50,2021-01-05T00:00:00,100,100,0,100
ΚΩ,1206,0,0,0,0,2021-01-05T00:00:00,0,0,0,0
ΛΑΚΩΝΙΑΣ,1004,0,0,0,0,2021-01-05T00:00:00,0,0,0,0
ΛΑΡΙΣΑΣ,502,215,0,-15,215,2021-01-05T00:00:00,951,951,0,951
ΛΑΣΙΘΙΟΥ,1302,0,0,0,0,2021-01-05T00:00:00,0,0,0,0
ΛΕΣΒΟΥ,1102,0,0,0,0,2021-01-05T00:00:00,0,0,0,0
ΛΕΥΚΑΔΑΣ,605,0,0,0,0,2021-01-05T00:00:00,0,0,0,0
ΛΗΜΝΟΥ,1103,0,0,0,0,2021-01-05T00:00:00,0,0,0,0
ΜΑΓΝΗΣΙΑΣ,503,0,0,0,0,2021-01-05T00:00:00,0,0,0,0
ΜΕΣΣΗΝΙΑΣ,1005,0,0,0,0,2021-01-05T00:00:00,0,0,0,0
ΜΗΛΟΥ,1207,0,0,0,0,2021-01-05T00:00:00,0,0,0,0
ΜΥΚΟΝΟΥ,1208,0,0,0,0,2021-01-05T00:00:00,0,0,0,0
ΝΑΞΟΥ,1209,0,0,0,0,2021-01-05T00:00:00,0,0,0,0
ΝΗΣΩΝ,906,0,0,0,0,2021-01-05T00:00:00,0,0,0,0
ΝΟΤΙΟΥ ΤΟΜΕΑ ΑΘΗΝΩΝ,907,0,0,0,0,2021-01-05T00:00:00,0,0,0,0
ΞΑΝΘΗΣ,105,0,0,0,0,2021-01-05T00:00:00,0,0,0,0
ΠΑΡΟΥ,1210,0,0,0,0,2021-01-05T00:00:00,0,0,0,0
ΠΕΙΡΑΙΩΣ,908,173,0,-3,173,2021-01-05T00:00:00,352,352,0,352
ΠΕΛΛΑΣ,204,65,0,-81,65,2021-01-05T00:00:00,211,211,0,211
ΠΙΕΡΙΑΣ,205,95,0,1,95,2021-01-05T00:00:00,189,189,0,189
ΠΡΕΒΕΖΑΣ,404,0,0,0,0,2021-01-05T00:00:00,0,0,0,0
ΡΕΘΥΜΝΟΥ,1303,0,0,0,0,2021-01-05T00:00:00,0,0,0,0
ΡΟΔΟΠΗΣ,106,0,0,0,0,2021-01-05T00:00:00,0,0,0,0
ΡΟΔΟΥ,1211,0,0,0,0,2021-01-05T00:00:00,0,0,0,0
ΣΑΜΟΥ,1104,0,0,0,0,2021-01-05T00:00:00,0,0,0,0
ΣΕΡΡΩΝ,206,0,0,0,0,2021-01-05T00:00:00,0,0,0,0
ΣΠΟΡΑΔΩΝ,504,0,0,0,0,2021-01-05T00:00:00,0,0,0,0
ΣΥΡΟΥ,1212,0,0,0,0,2021-01-05T00:00:00,0,0,0,0
ΤΗΝΟΥ,1213,0,0,0,0,2021-01-05T00:00:00,0,0,0,0
ΤΡΙΚΑΛΩΝ,505,60,0,-80,60,2021-01-05T00:00:00,200,200,0,200
ΦΘΙΩΤΙΔΑΣ,804,0,0,0,0,2021-01-05T00:00:00,0,0,0,0
ΦΛΩΡΙΝΑΣ,304,0,0,0,0,2021-01-05T00:00:00,0,0,0,0
ΦΩΚΙΔΑΣ,805,0,0,0,0,2021-01-05T00:00:00,0,0,0,0
ΧΑΛΚΙΔΙΚΗΣ,207,0,0,0,0,2021-01-05T00:00:00,0,0,0,0
ΧΑΝΙΩΝ,1304,145,0,-5,145,2021-01-05T00:00:00,295,295,0,295
ΧΙΟΥ,1105,0,0,0,0,2021-01-05T00:00:00,0,0,0,0
ΑΙΤΩΛΟΑΚΑΡΝΑΝΙΑΣ,701,50,0,0,50,2021-01-06T00:00:00,150,150,0,150
ΑΝΑΤΟΛΙΚΗΣ ΑΤΤΙΚΗΣ,901,60,0,20,60,2021-01-06T00:00:00,566,566,0,566
ΑΝΔΡΟΥ,1201,0,0,0,0,2021-01-06T00:00:00,0,0,0,0
ΑΡΓΟΛΙΔΑΣ,1001,0,0,0,0,2021-01-06T00:00:00,0,0,0,0
ΑΡΚΑΔΙΑΣ,1002,0,0,0,0,2021-01-06T00:00:00,0,0,0,0
ΑΡΤΑΣ,401,15,0,-80,15,2021-01-06T00:00:00,190,190,0,190
ΑΧΑΪΑΣ,702,40,0,-340,40,2021-01-06T00:00:00,1256,1256,0,1256
ΒΟΙΩΤΙΑΣ,801,0,0,0,0,2021-01-06T00:00:00,0,0,0,0
ΒΟΡΕΙΟΥ ΤΟΜΕΑ ΑΘΗΝΩΝ,902,439,0,-198,439,2021-01-06T00:00:00,1758,1758,0,1758
ΓΡΕΒΕΝΩΝ,301,0,0,0,0,2021-01-06T00:00:00,0,0,0,0
ΔΡΑΜΑΣ,101,0,0,0,0,2021-01-06T00:00:00,0,0,0,0
ΔΥΤΙΚΗΣ ΑΤΤΙΚΗΣ,903,0,0,-40,0,2021-01-06T00:00:00,339,339,0,339
ΔΥΤΙΚΟΥ ΤΟΜΕΑ ΑΘΗΝΩΝ,904,160,0,10,160,2021-01-06T00:00:00,845,845,0,845
ΕΒΡΟΥ,102,0,0,0,0,2021-01-06T00:00:00,0,0,0,0
ΕΥΒΟΙΑΣ,802,0,0,0,0,2021-01-06T00:00:00,0,0,0,0
ΕΥΡΥΤΑΝΙΑΣ,803,0,0,0,0,2021-01-06T00:00:00,0,0,0,0
ΖΑΚΥΝΘΟΥ,601,0,0,0,0,2021-01-06T00:00:00,0,0,0,0
ΗΛΕΙΑΣ,703,0,0,0,0,2021-01-06T00:00:00,0,0,0,0
ΗΜΑΘΙΑΣ,201,30,0,-20,30,2021-01-06T00:00:00,159,159,0,159
ΗΡΑΚΛΕΙΟΥ,1301,120,0,-5,120,2021-01-06T00:00:00,376,376,0,376
ΘΑΣΟΥ,103,0,0,0,0,2021-01-06T00:00:00,0,0,0,0
ΘΕΣΠΡΩΤΙΑΣ,402,0,0,0,0,2021-01-06T00:00:00,0,0,0,0
ΘΕΣΣΑΛΟΝΙΚΗΣ,202,550,0,-716,550,2021-01-06T00:00:00,3458,3458,0,3458
ΘΗΡΑΣ,1202,0,0,0,0,2021-01-06T00:00:00,0,0,0,0
ΙΘΑΚΗΣ,602,0,0,0,0,2021-01-06T00:00:00,0,0,0,0
ΙΚΑΡΙΑΣ,1101,0,0,0,0,2021-01-06T00:00:00,0,0,0,0
ΙΩΑΝΝΙΝΩΝ,403,160,0,-56,160,2021-01-06T00:00:00,1063,1063,0,1063
ΚΑΒΑΛΑΣ,104,0,0,0,0,2021-01-06T00:00:00,0,0,0,0
ΚΑΛΥΜΝΟΥ,1203,0,0,0,0,2021-01-06T00:00:00,0,0,0,0
ΚΑΡΔΙΤΣΑΣ,501,105,0,-35,105,2021-01-06T00:00:00,345,345,0,345
ΚΑΡΠΑΘΟΥ,1204,0,0,0,0,2021-01-06T00:00:00,0,0,0,0
ΚΑΣΤΟΡΙΑΣ,302,0,0,0,0,2021-01-06T00:00:00,0,0,0,0
ΚΕΑΣ-ΚΥΘΝΟΥ,1205,0,0,0,0,2021-01-06T00:00:00,0,0,0,0
ΚΕΝΤΡΙΚΟΥ ΤΟΜΕΑ ΑΘΗΝΩΝ,905,1509,0,-699,1509,2021-01-06T00:00:00,6838,6838,0,6838
ΚΕΡΚΥΡΑΣ,603,0,0,0,0,2021-01-06T00:00:00,0,0,0,0
ΚΕΦΑΛΛΗΝΙΑΣ,604,0,0,0,0,2021-01-06T00:00:00,0,0,0,0
ΚΙΛΚΙΣ,203,0,0,0,0,2021-01-06T00:00:00,0,0,0,0
ΚΟΖΑΝΗΣ,303,90,0,-14,90,2021-01-06T00:00:00,318,318,0,318
ΚΟΡΙΝΘΙΑΣ,1003,50,0,0,50,2021-01-06T00:00:00,150,150,0,150
ΚΩ,1206,0,0,0,0,2021-01-06T00:00:00,0,0,0,0
ΛΑΚΩΝΙΑΣ,1004,0,0,0,0,2021-01-06T00:00:00,0,0,0,0
ΛΑΡΙΣΑΣ,502,100,0,-115,100,2021-01-06T00:00:00,1051,1051,0,1051
ΛΑΣΙΘΙΟΥ,1302,0,0,0,0,2021-01-06T00:00:00,0,0,0,0
ΛΕΣΒΟΥ,1102,0,0,0,0,2021-01-06T00:00:00,0,0,0,0
ΛΕΥΚΑΔΑΣ,605,0,0,0,0,2021-01-06T00:00:00,0,0,0,0
ΛΗΜΝΟΥ,1103,0,0,0,0,2021-01-06T00:00:00,0,0,0,0
ΜΑΓΝΗΣΙΑΣ,503,0,0,0,0,2021-01-06T00:00:00,0,0,0,0
ΜΕΣΣΗΝΙΑΣ,1005,0,0,0,0,2021-01-06T00:00:00,0,0,0,0
ΜΗΛΟΥ,1207,0,0,0,0,2021-01-06T00:00:00,0,0,0,0
ΜΥΚΟΝΟΥ,1208,0,0,0,0,2021-01-06T00:00:00,0,0,0,0
ΝΑΞΟΥ,1209,0,0,0,0,2021-01-06T00:00:00,0,0,0,0
ΝΗΣΩΝ,906,0,0,0,0,2021-01-06T00:00:00,0,0,0,0
ΝΟΤΙΟΥ ΤΟΜΕΑ ΑΘΗΝΩΝ,907,0,0,0,0,2021-01-06T00:00:00,0,0,0,0
ΞΑΝΘΗΣ,105,0,0,0,0,2021-01-06T00:00:00,0,0,0,0
ΠΑΡΟΥ,1210,0,0,0,0,2021-01-06T00:00:00,0,0,0,0
ΠΕΙΡΑΙΩΣ,908,97,0,-76,97,2021-01-06T00:00:00,449,449,0,449
ΠΕΛΛΑΣ,204,100,0,35,100,2021-01-06T00:00:00,311,311,0,311
ΠΙΕΡΙΑΣ,205,70,0,-25,70,2021-01-06T00:00:00,259,259,0,259
ΠΡΕΒΕΖΑΣ,404,0,0,0,0,2021-01-06T00:00:00,0,0,0,0
ΡΕΘΥΜΝΟΥ,1303,0,0,0,0,2021-01-06T00:00:00,0,0,0,0
ΡΟΔΟΠΗΣ,106,0,0,0,0,2021-01-06T00:00:00,0,0,0,0
ΡΟΔΟΥ,1211,0,0,0,0,2021-01-06T00:00:00,0,0,0,0
ΣΑΜΟΥ,1104,0,0,0,0,2021-01-06T00:00:00,0,0,0,0
ΣΕΡΡΩΝ,206,0,0,0,0,2021-01-06T00:00:00,0,0,0,0
ΣΠΟΡΑΔΩΝ,504,0,0,0,0,2021-01-06T00:00:00,0,0,0,0
ΣΥΡΟΥ,1212,0,0,0,0,2021-01-06T00:00:00,0,0,0,0
ΤΗΝΟΥ,1213,0,0,0,0,2021-01-06T00:00:00,0,0,0,0
ΤΡΙΚΑΛΩΝ,505,85,0,25,85,2021-01-06T00:00:00,285,285,0,285
ΦΘΙΩΤΙΔΑΣ,804,0,0,0,0,2021-01-06T00:00:00,0,0,0,0
ΦΛΩΡΙΝΑΣ,304,0,0,0,0,2021-01-06T00:00:00,0,0,0,0
ΦΩΚΙΔΑΣ,805,0,0,0,0,2021-01-06T00:00:00,0,0,0,0
ΧΑΛΚΙΔΙΚΗΣ,207,0,0,0,0,2021-01-06T00:00:00,0,0,0,0
ΧΑΝΙΩΝ,1304,155,0,10,155,2021-01-06T00:00:00,450,450,0,450
ΧΙΟΥ,1105,0,0,0,0,2021-01-06T00:00:00,0,0,0,0
ΑΙΤΩΛΟΑΚΑΡΝΑΝΙΑΣ,701,133,88,29,221,2021-02-11T00:00:00,3609,3609,1092,4701
ΑΝΑΤΟΛΙΚΗΣ ΑΤΤΙΚΗΣ,901,160,313,-8,473,2021-02-11T00:00:00,9140,9140,1303,10443
ΑΝΔΡΟΥ,1201,0,0,0,0,2021-02-11T00:00:00,263,263,1,264
ΑΡΓΟΛΙΔΑΣ,1001,14,177,11,191,2021-02-11T00:00:00,2819,2819,865,3684
ΑΡΚΑΔΙΑΣ,1002,11,139,24,150,2021-02-11T00:00:00,2754,2754,844,3598
ΑΡΤΑΣ,401,19,131,-6,150,2021-02-11T00:00:00,2966,2966,893,3859
ΑΧΑΪΑΣ,702,40,413,-25,453,2021-02-11T00:00:00,9536,9536,3363,12899
ΒΟΙΩΤΙΑΣ,801,19,143,-5,162,2021-02-11T00:00:00,2619,2619,756,3375
ΒΟΡΕΙΟΥ ΤΟΜΕΑ ΑΘΗΝΩΝ,902,978,2707,1555,3685,2021-02-11T00:00:00,42601,42601,18969,61570
ΓΡΕΒΕΝΩΝ,301,36,48,-18,84,2021-02-11T00:00:00,1119,1119,364,1483
ΔΡΑΜΑΣ,101,49,180,9,229,2021-02-11T00:00:00,3031,3031,843,3874
ΔΥΤΙΚΗΣ ΑΤΤΙΚΗΣ,903,3,159,36,162,2021-02-11T00:00:00,2969,2969,861,3830
ΔΥΤΙΚΟΥ ΤΟΜΕΑ ΑΘΗΝΩΝ,904,539,491,-161,1030,2021-02-11T00:00:00,16345,16345,3959,20304
ΕΒΡΟΥ,102,66,289,1,355,2021-02-11T00:00:00,5076,5076,2016,7092
ΕΥΒΟΙΑΣ,802,23,342,-55,365,2021-02-11T00:00:00,5675,5675,1681,7356
ΕΥΡΥΤΑΝΙΑΣ,803,2,28,-6,30,2021-02-11T00:00:00,646,646,267,913
ΖΑΚΥΝΘΟΥ,601,1,95,-6,96,2021-02-11T00:00:00,1297,1297,429,1726
ΗΛΕΙΑΣ,703,31,207,56,238,2021-02-11T00:00:00,3642,3642,1117,4759
ΗΜΑΘΙΑΣ,201,58,204,4,262,2021-02-11T00:00:00,4004,4004,1105,5109
ΗΡΑΚΛΕΙΟΥ,1301,53,524,-21,577,2021-02-11T00:00:00,9084,9084,4215,13299
ΘΑΣΟΥ,103,0,0,-6,0,2021-02-11T00:00:00,405,405,14,419
ΘΕΣΠΡΩΤΙΑΣ,402,39,93,-17,132,2021-02-11T00:00:00,2143,2143,566,2709
ΘΕΣΣΑΛΟΝΙΚΗΣ,202,818,1391,-132,2209,2021-02-11T00:00:00,39427,39427,14762,54189
ΘΗΡΑΣ,1202,6,24,6,30,2021-02-11T00:00:00,333,333,104,437
ΙΘΑΚΗΣ,602,0,0,0,0,2021-02-11T00:00:00,0,0,0,0
ΙΚΑΡΙΑΣ,1101,1,23,6,24,2021-02-11T00:00:00,685,685,101,786
ΙΩΑΝΝΙΝΩΝ,403,128,243,-3,371,2021-02-11T00:00:00,7464,7464,3428,10892
ΚΑΒΑΛΑΣ,104,62,218,28,280,2021-02-11T00:00:00,4034,4034,1109,5143
ΚΑΛΥΜΝΟΥ,1203,7,59,30,66,2021-02-11T00:00:00,690,690,239,929
ΚΑΡΔΙΤΣΑΣ,501,19,197,-29,216,2021-02-11T00:00:00,3880,3880,1117,4997
ΚΑΡΠΑΘΟΥ,1204,0,18,6,18,2021-02-11T00:00:00,252,252,45,297
ΚΑΣΤΟΡΙΑΣ,302,28,93,1,121,2021-02-11T00:00:00,1943,1943,521,2464
ΚΕΑΣ-ΚΥΘΝΟΥ,1205,6,0,6,6,2021-02-11T00:00:00,6,6,0,6
ΚΕΝΤΡΙΚΟΥ ΤΟΜΕΑ ΑΘΗΝΩΝ,905,1777,1529,-99,3306,2021-02-11T00:00:00,57825,57825,23321,81146
ΚΕΡΚΥΡΑΣ,603,33,230,22,263,2021-02-11T00:00:00,3061,3061,870,3931
ΚΕΦΑΛΛΗΝΙΑΣ,604,5,113,-18,118,2021-02-11T00:00:00,1634,1634,609,2243
ΚΙΛΚΙΣ,203,99,183,-31,282,2021-02-11T00:00:00,2876,2876,804,3680
ΚΟΖΑΝΗΣ,303,184,140,24,324,2021-02-11T00:00:00,4166,4166,1142,5308
ΚΟΡΙΝΘΙΑΣ,1003,69,105,24,174,2021-02-11T00:00:00,2839,2839,551,3390
ΚΩ,1206,0,42,-24,42,2021-02-11T00:00:00,927,927,290,1217
ΛΑΚΩΝΙΑΣ,1004,5,162,5,167,2021-02-11T00:00:00,2814,2814,917,3731
ΛΑΡΙΣΑΣ,502,158,215,1,373,2021-02-11T00:00:00,7287,7287,2492,9779
ΛΑΣΙΘΙΟΥ,1302,20,226,-11,246,2021-02-11T00:00:00,3910,3910,1252,5162
ΛΕΣΒΟΥ,1102,3,179,20,182,2021-02-11T00:00:00,2560,2560,771,3331
ΛΕΥΚΑΔΑΣ,605,6,60,-73,66,2021-02-11T00:00:00,1335,1335,273,1608
ΛΗΜΝΟΥ,1103,4,2,-42,6,2021-02-11T00:00:00,757,757,261,1018
ΜΑΓΝΗΣΙΑΣ,503,118,117,50,235,2021-02-11T00:00:00,4236,4236,906,5142
ΜΕΣΣΗΝΙΑΣ,1005,36,225,4,261,2021-02-11T00:00:00,4821,4821,1160,5981
ΜΗΛΟΥ,1207,18,0,-6,18,2021-02-11T00:00:00,230,230,2,232
ΜΥΚΟΝΟΥ,1208,0,0,0,0,2021-02-11T00:00:00,144,144,0,144
ΝΑΞΟΥ,1209,2,28,0,30,2021-02-11T00:00:00,436,436,126,562
ΝΗΣΩΝ,906,34,8,-6,42,2021-02-11T00:00:00,1630,1630,84,1714
ΝΟΤΙΟΥ ΤΟΜΕΑ ΑΘΗΝΩΝ,907,267,256,-28,523,2021-02-11T00:00:00,7485,7485,1964,9449
ΞΑΝΘΗΣ,105,17,116,-18,133,2021-02-11T00:00:00,2299,2299,890,3189
ΠΑΡΟΥ,1210,0,0,-6,0,2021-02-11T00:00:00,286,286,2,288
ΠΕΙΡΑΙΩΣ,908,231,485,-2,716,2021-02-11T00:00:00,14357,14357,4062,18419
ΠΕΛΛΑΣ,204,106,227,16,333,2021-02-11T00:00:00,4904,4904,1103,6007
ΠΙΕΡΙΑΣ,205,101,101,-20,202,2021-02-11T00:00:00,3615,3615,721,4336
ΠΡΕΒΕΖΑΣ,404,5,61,9,66,2021-02-11T00:00:00,1096,1096,516,1612
ΡΕΘΥΜΝΟΥ,1303,13,137,-24,150,2021-02-11T00:00:00,2383,2383,818,3201
ΡΟΔΟΠΗΣ,106,70,98,12,168,2021-02-11T00:00:00,1928,1928,571,2499
ΡΟΔΟΥ,1211,66,91,25,157,2021-02-11T00:00:00,2425,2425,690,3115
ΣΑΜΟΥ,1104,0,60,12,60,2021-02-11T00:00:00,881,881,337,1218
ΣΕΡΡΩΝ,206,88,133,-1,221,2021-02-11T00:00:00,3118,3118,1011,4129
ΣΠΟΡΑΔΩΝ,504,16,2,0,18,2021-02-11T00:00:00,235,235,5,240
ΣΥΡΟΥ,1212,0,48,-6,48,2021-02-11T00:00:00,871,871,282,1153
ΤΗΝΟΥ,1213,0,0,0,0,2021-02-11T00:00:00,280,280,1,281
ΤΡΙΚΑΛΩΝ,505,69,208,12,277,2021-02-11T00:00:00,4236,4236,1208,5444
ΦΘΙΩΤΙΔΑΣ,804,56,201,23,257,2021-02-11T00:00:00,3301,3301,1151,4452
ΦΛΩΡΙΝΑΣ,304,16,103,29,119,2021-02-11T00:00:00,1643,1643,479,2122
ΦΩΚΙΔΑΣ,805,7,49,4,56,2021-02-11T00:00:00,971,971,268,1239
ΧΑΛΚΙΔΙΚΗΣ,207,71,116,1,187,2021-02-11T00:00:00,2341,2341,529,2870
ΧΑΝΙΩΝ,1304,52,344,-13,396,2021-02-11T00:00:00,6646,6646,1817,8463
ΧΙΟΥ,1105,217,56,43,273,2021-02-11T00:00:00,1554,1554,411,1965
ΑΙΤΩΛΟΑΚΑΡΝΑΝΙΑΣ,701,108,109,-4,217,2021-02-12T00:00:00,3717,3717,1201,4918
ΑΝΑΤΟΛΙΚΗΣ ΑΤΤΙΚΗΣ,901,139,387,53,526,2021-02-12T00:00:00,9279,9279,1690,10969
ΑΝΔΡΟΥ,1201,0,0,0,0,2021-02-12T00:00:00,263,263,1,264
ΑΡΓΟΛΙΔΑΣ,1001,7,161,-23,168,2021-02-12T00:00:00,2826,2826,1026,3852
ΑΡΚΑΔΙΑΣ,1002,14,142,6,156,2021-02-12T00:00:00,2768,2768,986,3754
ΑΡΤΑΣ,401,28,152,30,180,2021-02-12T00:00:00,2994,2994,1045,4039
ΑΧΑΪΑΣ,702,28,497,72,525,2021-02-12T00:00:00,9564,9564,3860,13424
ΒΟΙΩΤΙΑΣ,801,15,147,0,162,2021-02-12T00:00:00,2634,2634,903,3537
ΒΟΡΕΙΟΥ ΤΟΜΕΑ ΑΘΗΝΩΝ,902,993,2671,-21,3664,2021-02-12T00:00:00,43594,43594,21640,65234
ΓΡΕΒΕΝΩΝ,301,28,50,-6,78,2021-02-12T00:00:00,1147,1147,414,1561
ΔΡΑΜΑΣ,101,51,176,-2,227,2021-02-12T00:00:00,3082,3082,1019,4101
ΔΥΤΙΚΗΣ ΑΤΤΙΚΗΣ,903,9,255,102,264,2021-02-12T00:00:00,2978,2978,1116,4094
ΔΥΤΙΚΟΥ ΤΟΜΕΑ ΑΘΗΝΩΝ,904,336,678,-16,1014,2021-02-12T00:00:00,16681,16681,4637,21318
ΕΒΡΟΥ,102,58,291,-6,349,2021-02-12T00:00:00,5134,5134,2307,7441
ΕΥΒΟΙΑΣ,802,24,292,-49,316,2021-02-12T00:00:00,5699,5699,1973,7672
ΕΥΡΥΤΑΝΙΑΣ,803,7,35,12,42,2021-02-12T00:00:00,653,653,302,955
ΖΑΚΥΝΘΟΥ,601,3,80,-13,83,2021-02-12T00:00:00,1300,1300,509,1809
ΗΛΕΙΑΣ,703,24,192,-22,216,2021-02-12T00:00:00,3666,3666,1309,4975
ΗΜΑΘΙΑΣ,201,70,214,22,284,2021-02-12T00:00:00,4074,4074,1319,5393
ΗΡΑΚΛΕΙΟΥ,1301,15,531,-31,546,2021-02-12T00:00:00,9099,9099,4746,13845
ΘΑΣΟΥ,103,10,2,12,12,2021-02-12T00:00:00,415,415,16,431
ΘΕΣΠΡΩΤΙΑΣ,402,8,120,-4,128,2021-02-12T00:00:00,2151,2151,686,2837
ΘΕΣΣΑΛΟΝΙΚΗΣ,202,710,1892,393,2602,2021-02-12T00:00:00,40137,40137,16654,56791
ΘΗΡΑΣ,1202,15,21,6,36,2021-02-12T00:00:00,348,348,125,473
ΙΘΑΚΗΣ,602,59,0,59,59,2021-02-12T00:00:00,59,59,0,59
ΙΚΑΡΙΑΣ,1101,4,25,5,29,2021-02-12T00:00:00,689,689,126,815
ΙΩΑΝΝΙΝΩΝ,403,23,384,36,407,2021-02-12T00:00:00,7487,7487,3812,11299
ΚΑΒΑΛΑΣ,104,63,221,4,284,2021-02-12T00:00:00,4097,4097,1330,5427
ΚΑΛΥΜΝΟΥ,1203,2,58,-6,60,2021-02-12T00:00:00,692,692,297,989
ΚΑΡΔΙΤΣΑΣ,501,27,248,59,275,2021-02-12T00:00:00,3907,3907,1365,5272
ΚΑΡΠΑΘΟΥ,1204,5,25,12,30,2021-02-12T00:00:00,257,257,70,327
ΚΑΣΤΟΡΙΑΣ,302,13,107,-1,120,2021-02-12T00:00:00,1956,1956,628,2584
ΚΕΑΣ-ΚΥΘΝΟΥ,1205,12,0,6,12,2021-02-12T00:00:00,18,18,0,18
ΚΕΝΤΡΙΚΟΥ ΤΟΜΕΑ ΑΘΗΝΩΝ,905,1239,1780,-287,3019,2021-02-12T00:00:00,59064,59064,25101,84165
ΚΕΡΚΥΡΑΣ,603,39,230,6,269,2021-02-12T00:00:00,3100,3100,1100,4200
ΚΕΦΑΛΛΗΝΙΑΣ,604,5,127,14,132,2021-02-12T00:00:00,1639,1639,736,2375
ΚΙΛΚΙΣ,203,58,176,-48,234,2021-02-12T00:00:00,2934,2934,980,3914
ΚΟΖΑΝΗΣ,303,90,192,-42,282,2021-02-12T00:00:00,4256,4256,1334,5590
ΚΟΡΙΝΘΙΑΣ,1003,33,135,-6,168,2021-02-12T00:00:00,2872,2872,686,3558
ΚΩ,1206,3,57,18,60,2021-02-12T00:00:00,930,930,347,1277
ΛΑΚΩΝΙΑΣ,1004,8,155,-4,163,2021-02-12T00:00:00,2822,2822,1072,3894
ΛΑΡΙΣΑΣ,502,111,297,35,408,2021-02-12T00:00:00,7398,7398,2789,10187
ΛΑΣΙΘΙΟΥ,1302,12,226,-8,238,2021-02-12T00:00:00,3922,3922,1478,5400
ΛΕΣΒΟΥ,1102,1,143,-38,144,2021-02-12T00:00:00,2561,2561,914,3475
ΛΕΥΚΑΔΑΣ,605,72,61,67,133,2021-02-12T00:00:00,1407,1407,334,1741
ΛΗΜΝΟΥ,1103,8,46,48,54,2021-02-12T00:00:00,765,765,307,1072
ΜΑΓΝΗΣΙΑΣ,503,106,141,12,247,2021-02-12T00:00:00,4342,4342,1047,5389
ΜΕΣΣΗΝΙΑΣ,1005,48,210,-3,258,2021-02-12T00:00:00,4869,4869,1370,6239
ΜΗΛΟΥ,1207,0,0,-18,0,2021-02-12T00:00:00,230,230,2,232
ΜΥΚΟΝΟΥ,1208,0,0,0,0,2021-02-12T00:00:00,144,144,0,144
ΝΑΞΟΥ,1209,4,27,1,31,2021-02-12T00:00:00,440,440,153,593
ΝΗΣΩΝ,906,12,30,0,42,2021-02-12T00:00:00,1642,1642,114,1756
ΝΟΤΙΟΥ ΤΟΜΕΑ ΑΘΗΝΩΝ,907,214,362,53,576,2021-02-12T00:00:00,7699,7699,2326,10025
ΞΑΝΘΗΣ,105,12,120,-1,132,2021-02-12T00:00:00,2311,2311,1010,3321
ΠΑΡΟΥ,1210,0,0,0,0,2021-02-12T00:00:00,286,286,2,288
ΠΕΙΡΑΙΩΣ,908,165,836,285,1001,2021-02-12T00:00:00,14522,14522,4898,19420
ΠΕΛΛΑΣ,204,114,207,-12,321,2021-02-12T00:00:00,5018,5018,1310,6328
ΠΙΕΡΙΑΣ,205,89,156,43,245,2021-02-12T00:00:00,3704,3704,877,4581
ΠΡΕΒΕΖΑΣ,404,5,61,0,66,2021-02-12T00:00:00,1101,1101,577,1678
ΡΕΘΥΜΝΟΥ,1303,7,125,-18,132,2021-02-12T00:00:00,2390,2390,943,3333
ΡΟΔΟΠΗΣ,106,81,95,8,176,2021-02-12T00:00:00,2009,2009,666,2675
ΡΟΔΟΥ,1211,59,85,-13,144,2021-02-12T00:00:00,2484,2484,775,3259
ΣΑΜΟΥ,1104,5,55,0,60,2021-02-12T00:00:00,886,886,392,1278
ΣΕΡΡΩΝ,206,83,146,8,229,2021-02-12T00:00:00,3201,3201,1157,4358
ΣΠΟΡΑΔΩΝ,504,0,0,-18,0,2021-02-12T00:00:00,235,235,5,240
ΣΥΡΟΥ,1212,0,60,12,60,2021-02-12T00:00:00,871,871,342,1213
ΤΗΝΟΥ,1213,0,0,0,0,2021-02-12T00:00:00,280,280,1,281
ΤΡΙΚΑΛΩΝ,505,60,251,34,311,2021-02-12T00:00:00,4296,4296,1459,5755
ΦΘΙΩΤΙΔΑΣ,804,65,217,25,282,2021-02-12T00:00:00,3366,3366,1368,4734
ΦΛΩΡΙΝΑΣ,304,6,108,-5,114,2021-02-12T00:00:00,1649,1649,587,2236
ΦΩΚΙΔΑΣ,805,1,60,5,61,2021-02-12T00:00:00,972,972,328,1300
ΧΑΛΚΙΔΙΚΗΣ,207,27,129,-31,156,2021-02-12T00:00:00,2368,2368,658,3026
ΧΑΝΙΩΝ,1304,40,338,-18,378,2021-02-12T00:00:00,6686,6686,2155,8841
ΧΙΟΥ,1105,159,66,-48,225,2021-02-12T00:00:00,1713,1713,477,2190
ΑΙΤΩΛΟΑΚΑΡΝΑΝΙΑΣ,701,111,135,29,246,2021-02-13T00:00:00,3828,3828,1336,5164
ΑΝΑΤΟΛΙΚΗΣ ΑΤΤΙΚΗΣ,901,108,400,-18,508,2021-02-13T00:00:00,9387,9387,2090,11477
ΑΝΔΡΟΥ,1201,0,0,0,0,2021-02-13T00:00:00,263,263,1,264
ΑΡΓΟΛΙΔΑΣ,1001,45,129,6,174,2021-02-13T00:00:00,2871,2871,1155,4026
ΑΡΚΑΔΙΑΣ,1002,13,167,24,180,2021-02-13T00:00:00,2781,2781,1153,3934
ΑΡΤΑΣ,401,11,174,5,185,2021-02-13T00:00:00,3005,3005,1219,4224
ΑΧΑΪΑΣ,702,32,448,-45,480,2021-02-13T00:00:00,9596,9596,4308,13904
ΒΟΙΩΤΙΑΣ,801,34,127,-1,161,2021-02-13T00:00:00,2668,2668,1030,3698
ΒΟΡΕΙΟΥ ΤΟΜΕΑ ΑΘΗΝΩΝ,902,507,1657,-1500,2164,2021-02-13T00:00:00,44101,44101,23297,67398
ΓΡΕΒΕΝΩΝ,301,11,43,-24,54,2021-02-13T00:00:00,1158,1158,457,1615
ΔΡΑΜΑΣ,101,42,140,-45,182,2021-02-13T00:00:00,3124,3124,1159,4283
ΔΥΤΙΚΗΣ ΑΤΤΙΚΗΣ,903,13,209,-42,222,2021-02-13T00:00:00,2991,2991,1325,4316
ΔΥΤΙΚΟΥ ΤΟΜΕΑ ΑΘΗΝΩΝ,904,256,801,43,1057,2021-02-13T00:00:00,16937,16937,5438,22375
ΕΒΡΟΥ,102,52,248,-49,300,2021-02-13T00:00:00,5186,5186,2555,7741
ΕΥΒΟΙΑΣ,802,18,246,-52,264,2021-02-13T00:00:00,5717,5717,2219,7936
ΕΥΡΥΤΑΝΙΑΣ,803,2,22,-18,24,2021-02-13T00:00:00,655,655,324,979
ΖΑΚΥΝΘΟΥ,601,2,82,1,84,2021-02-13T00:00:00,1302,1302,591,1893
ΗΛΕΙΑΣ,703,17,157,-42,174,2021-02-13T00:00:00,3683,3683,1466,5149
ΗΜΑΘΙΑΣ,201,81,177,-26,258,2021-02-13T00:00:00,4155,4155,1496,5651
ΗΡΑΚΛΕΙΟΥ,1301,36,456,-54,492,2021-02-13T00:00:00,9135,9135,5202,14337
ΘΑΣΟΥ,103,0,0,-12,0,2021-02-13T00:00:00,415,415,16,431
ΘΕΣΠΡΩΤΙΑΣ,402,2,124,-2,126,2021-02-13T00:00:00,2153,2153,810,2963
ΘΕΣΣΑΛΟΝΙΚΗΣ,202,636,1732,-234,2368,2021-02-13T00:00:00,40773,40773,18386,59159
ΘΗΡΑΣ,1202,7,5,-24,12,2021-02-13T00:00:00,355,355,130,485
ΙΘΑΚΗΣ,602,18,0,-41,18,2021-02-13T00:00:00,77,77,0,77
ΙΚΑΡΙΑΣ,1101,1,17,-11,18,2021-02-13T00:00:00,690,690,143,833
ΙΩΑΝΝΙΝΩΝ,403,42,343,-22,385,2021-02-13T00:00:00,7529,7529,4155,11684
ΚΑΒΑΛΑΣ,104,68,207,-9,275,2021-02-13T00:00:00,4165,4165,1537,5702
ΚΑΛΥΜΝΟΥ,1203,0,36,-24,36,2021-02-13T00:00:00,692,692,333,1025
ΚΑΡΔΙΤΣΑΣ,501,33,203,-39,236,2021-02-13T00:00:00,3940,3940,1568,5508
ΚΑΡΠΑΘΟΥ,1204,0,18,-12,18,2021-02-13T00:00:00,257,257,88,345
ΚΑΣΤΟΡΙΑΣ,302,22,86,-12,108,2021-02-13T00:00:00,1978,1978,714,2692
ΚΕΑΣ-ΚΥΘΝΟΥ,1205,0,0,-12,0,2021-02-13T00:00:00,18,18,0,18
ΚΕΝΤΡΙΚΟΥ ΤΟΜΕΑ ΑΘΗΝΩΝ,905,1035,1698,-286,2733,2021-02-13T00:00:00,60099,60099,26799,86898
ΚΕΡΚΥΡΑΣ,603,50,231,12,281,2021-02-13T00:00:00,3150,3150,1331,4481
ΚΕΦΑΛΛΗΝΙΑΣ,604,2,58,-72,60,2021-02-13T00:00:00,1641,1641,794,2435
ΚΙΛΚΙΣ,203,34,104,-96,138,2021-02-13T00:00:00,2968,2968,1084,4052
ΚΟΖΑΝΗΣ,303,49,185,-48,234,2021-02-13T00:00:00,4305,4305,1519,5824
ΚΟΡΙΝΘΙΑΣ,1003,34,128,-6,162,2021-02-13T00:00:00,2906,2906,814,3720
ΚΩ,1206,0,30,-30,30,2021-02-13T00:00:00,930,930,377,1307
ΛΑΚΩΝΙΑΣ,1004,15,140,-8,155,2021-02-13T00:00:00,2837,2837,1212,4049
ΛΑΡΙΣΑΣ,502,127,353,72,480,2021-02-13T00:00:00,7525,7525,3142,10667
ΛΑΣΙΘΙΟΥ,1302,11,200,-27,211,2021-02-13T00:00:00,3933,3933,1678,5611
ΛΕΣΒΟΥ,1102,5,139,0,144,2021-02-13T00:00:00,2566,2566,1053,3619
ΛΕΥΚΑΔΑΣ,605,2,64,-67,66,2021-02-13T00:00:00,1409,1409,398,1807
ΛΗΜΝΟΥ,1103,6,36,-12,42,2021-02-13T00:00:00,771,771,343,1114
ΜΑΓΝΗΣΙΑΣ,503,101,181,35,282,2021-02-13T00:00:00,4443,4443,1228,5671
ΜΕΣΣΗΝΙΑΣ,1005,43,235,20,278,2021-02-13T00:00:00,4912,4912,1605,6517
ΜΗΛΟΥ,1207,0,0,0,0,2021-02-13T00:00:00,230,230,2,232
ΜΥΚΟΝΟΥ,1208,0,0,0,0,2021-02-13T00:00:00,144,144,0,144
ΝΑΞΟΥ,1209,2,16,-13,18,2021-02-13T00:00:00,442,442,169,611
ΝΗΣΩΝ,906,4,17,-21,21,2021-02-13T00:00:00,1646,1646,131,1777
ΝΟΤΙΟΥ ΤΟΜΕΑ ΑΘΗΝΩΝ,907,184,285,-107,469,2021-02-13T00:00:00,7883,7883,2611,10494
ΞΑΝΘΗΣ,105,21,99,-12,120,2021-02-13T00:00:00,2332,2332,1109,3441
ΠΑΡΟΥ,1210,4,2,6,6,2021-02-13T00:00:00,290,290,4,294
ΠΕΙΡΑΙΩΣ,908,83,721,-197,804,2021-02-13T00:00:00,14605,14605,5619,20224
ΠΕΛΛΑΣ,204,97,191,-33,288,2021-02-13T00:00:00,5115,5115,1501,6616
ΠΙΕΡΙΑΣ,205,57,189,1,246,2021-02-13T00:00:00,3761,3761,1066,4827
ΠΡΕΒΕΖΑΣ,404,6,71,11,77,2021-02-13T00:00:00,1107,1107,648,1755
ΡΕΘΥΜΝΟΥ,1303,15,123,6,138,2021-02-13T00:00:00,2405,2405,1066,3471
ΡΟΔΟΠΗΣ,106,95,95,14,190,2021-02-13T00:00:00,2104,2104,761,2865
ΡΟΔΟΥ,1211,28,104,-12,132,2021-02-13T00:00:00,2512,2512,879,3391
ΣΑΜΟΥ,1104,5,37,-18,42,2021-02-13T00:00:00,891,891,429,1320
ΣΕΡΡΩΝ,206,79,143,-7,222,2021-02-13T00:00:00,3280,3280,1300,4580
ΣΠΟΡΑΔΩΝ,504,4,2,6,6,2021-02-13T00:00:00,239,239,7,246
ΣΥΡΟΥ,1212,4,44,-12,48,2021-02-13T00:00:00,875,875,386,1261
ΤΗΝΟΥ,1213,0,0,0,0,2021-02-13T00:00:00,280,280,1,281
ΤΡΙΚΑΛΩΝ,505,105,261,55,366,2021-02-13T00:00:00,4401,4401,1720,6121
ΦΘΙΩΤΙΔΑΣ,804,75,195,-12,270,2021-02-13T00:00:00,3441,3441,1563,5004
ΦΛΩΡΙΝΑΣ,304,11,85,-18,96,2021-02-13T00:00:00,1660,1660,672,2332
ΦΩΚΙΔΑΣ,805,3,61,3,64,2021-02-13T00:00:00,975,975,389,1364
ΧΑΛΚΙΔΙΚΗΣ,207,19,111,-26,130,2021-02-13T00:00:00,2387,2387,769,3156
ΧΑΝΙΩΝ,1304,38,340,0,378,2021-02-13T00:00:00,6724,6724,2495,9219
ΧΙΟΥ,1105,40,55,-130,95,2021-02-13T00:00:00,1753,1753,532,2285
ΑΙΤΩΛΟΑΚΑΡΝΑΝΙΑΣ,701,345,101,200,446,2021-02-15T00:00:00,4173,4173,1437,5610
ΑΝΑΤΟΛΙΚΗΣ ΑΤΤΙΚΗΣ,901,298,343,133,641,2021-02-15T00:00:00,9685,9685,2433,12118
ΑΝΔΡΟΥ,1201,0,0,0,0,2021-02-15T00:00:00,263,263,1,264
ΑΡΓΟΛΙΔΑΣ,1001,112,136,74,248,2021-02-15T00:00:00,2983,2983,1291,4274
ΑΡΚΑΔΙΑΣ,1002,98,161,79,259,2021-02-15T00:00:00,2879,2879,1314,4193
ΑΡΤΑΣ,401,54,154,23,208,2021-02-15T00:00:00,3059,3059,1373,4432
ΑΧΑΪΑΣ,702,250,365,135,615,2021-02-15T00:00:00,9846,9846,4673,14519
ΒΟΙΩΤΙΑΣ,801,97,81,17,178,2021-02-15T00:00:00,2765,2765,1111,3876
ΒΟΡΕΙΟΥ ΤΟΜΕΑ ΑΘΗΝΩΝ,902,3160,1927,2923,5087,2021-02-15T00:00:00,47261,47261,25224,72485
ΓΡΕΒΕΝΩΝ,301,18,45,9,63,2021-02-15T00:00:00,1176,1176,502,1678
ΔΡΑΜΑΣ,101,59,142,19,201,2021-02-15T00:00:00,3183,3183,1301,4484
ΔΥΤΙΚΗΣ ΑΤΤΙΚΗΣ,903,79,110,-33,189,2021-02-15T00:00:00,3070,3070,1435,4505
ΔΥΤΙΚΟΥ ΤΟΜΕΑ ΑΘΗΝΩΝ,904,396,657,-4,1053,2021-02-15T00:00:00,17333,17333,6095,23428
ΕΒΡΟΥ,102,170,225,95,395,2021-02-15T00:00:00,5356,5356,2780,8136
ΕΥΒΟΙΑΣ,802,99,232,67,331,2021-02-15T00:00:00,5816,5816,2451,8267
ΕΥΡΥΤΑΝΙΑΣ,803,7,30,13,37,2021-02-15T00:00:00,662,662,354,1016
ΖΑΚΥΝΘΟΥ,601,4,98,18,102,2021-02-15T00:00:00,1306,1306,689,1995
ΗΛΕΙΑΣ,703,99,189,114,288,2021-02-15T00:00:00,3782,3782,1655,5437
ΗΜΑΘΙΑΣ,201,170,138,50,308,2021-02-15T00:00:00,4325,4325,1634,5959
ΗΡΑΚΛΕΙΟΥ,1301,323,352,183,675,2021-02-15T00:00:00,9458,9458,5554,15012
ΘΑΣΟΥ,103,0,0,0,0,2021-02-15T00:00:00,415,415,16,431
ΘΕΣΠΡΩΤΙΑΣ,402,49,123,46,172,2021-02-15T00:00:00,2202,2202,933,3135
ΘΕΣΣΑΛΟΝΙΚΗΣ,202,1845,1179,656,3024,2021-02-15T00:00:00,42618,42618,19565,62183
ΘΗΡΑΣ,1202,15,19,22,34,2021-02-15T00:00:00,370,370,149,519
ΙΘΑΚΗΣ,602,0,0,-18,0,2021-02-15T00:00:00,77,77,0,77
ΙΚΑΡΙΑΣ,1101,0,29,11,29,2021-02-15T00:00:00,690,690,172,862
ΙΩΑΝΝΙΝΩΝ,403,257,301,173,558,2021-02-15T00:00:00,7786,7786,4456,12242
ΚΑΒΑΛΑΣ,104,116,186,27,302,2021-02-15T00:00:00,4281,4281,1723,6004
ΚΑΛΥΜΝΟΥ,1203,6,44,14,50,2021-02-15T00:00:00,698,698,377,1075
ΚΑΡΔΙΤΣΑΣ,501,172,180,116,352,2021-02-15T00:00:00,4112,4112,1748,5860
ΚΑΡΠΑΘΟΥ,1204,0,18,0,18,2021-02-15T00:00:00,257,257,106,363
ΚΑΣΤΟΡΙΑΣ,302,47,86,25,133,2021-02-15T00:00:00,2025,2025,800,2825
ΚΕΑΣ-ΚΥΘΝΟΥ,1205,13,0,13,13,2021-02-15T00:00:00,31,31,0,31
ΚΕΝΤΡΙΚΟΥ ΤΟΜΕΑ ΑΘΗΝΩΝ,905,2051,1164,482,3215,2021-02-15T00:00:00,62150,62150,27963,90113
ΚΕΡΚΥΡΑΣ,603,86,244,49,330,2021-02-15T00:00:00,3236,3236,1575,4811
ΚΕΦΑΛΛΗΝΙΑΣ,604,6,84,30,90,2021-02-15T00:00:00,1647,1647,878,2525
ΚΙΛΚΙΣ,203,55,137,54,192,2021-02-15T00:00:00,3023,3023,1221,4244
ΚΟΖΑΝΗΣ,303,242,76,84,318,2021-02-15T00:00:00,4547,4547,1595,6142
ΚΟΡΙΝΘΙΑΣ,1003,204,106,148,310,2021-02-15T00:00:00,3110,3110,920,4030
ΚΩ,1206,40,50,60,90,2021-02-15T00:00:00,970,970,427,1397
ΛΑΚΩΝΙΑΣ,1004,123,139,107,262,2021-02-15T00:00:00,2960,2960,1351,4311
ΛΑΡΙΣΑΣ,502,385,314,219,699,2021-02-15T00:00:00,7910,7910,3456,11366
ΛΑΣΙΘΙΟΥ,1302,57,202,48,259,2021-02-15T00:00:00,3990,3990,1880,5870
ΛΕΣΒΟΥ,1102,43,159,58,202,2021-02-15T00:00:00,2609,2609,1212,3821
ΛΕΥΚΑΔΑΣ,605,49,60,43,109,2021-02-15T00:00:00,1458,1458,458,1916
ΛΗΜΝΟΥ,1103,1,41,0,42,2021-02-15T00:00:00,772,772,384,1156
ΜΑΓΝΗΣΙΑΣ,503,145,181,44,326,2021-02-15T00:00:00,4588,4588,1409,5997
ΜΕΣΣΗΝΙΑΣ,1005,114,298,134,412,2021-02-15T00:00:00,5026,5026,1903,6929
ΜΗΛΟΥ,1207,0,0,0,0,2021-02-15T00:00:00,230,230,2,232
ΜΥΚΟΝΟΥ,1208,0,0,0,0,2021-02-15T00:00:00,144,144,0,144
ΝΑΞΟΥ,1209,3,21,6,24,2021-02-15T00:00:00,445,445,190,635
ΝΗΣΩΝ,906,25,19,23,44,2021-02-15T00:00:00,1671,1671,150,1821
ΝΟΤΙΟΥ ΤΟΜΕΑ ΑΘΗΝΩΝ,907,474,273,278,747,2021-02-15T00:00:00,8357,8357,2884,11241
ΞΑΝΘΗΣ,105,43,92,15,135,2021-02-15T00:00:00,2375,2375,1201,3576
ΠΑΡΟΥ,1210,0,0,-6,0,2021-02-15T00:00:00,290,290,4,294
ΠΕΙΡΑΙΩΣ,908,445,585,226,1030,2021-02-15T00:00:00,15050,15050,6204,21254
ΠΕΛΛΑΣ,204,203,151,66,354,2021-02-15T00:00:00,5318,5318,1652,6970
ΠΙΕΡΙΑΣ,205,129,87,-30,216,2021-02-15T00:00:00,3890,3890,1153,5043
ΠΡΕΒΕΖΑΣ,404,98,67,88,165,2021-02-15T00:00:00,1205,1205,715,1920
ΡΕΘΥΜΝΟΥ,1303,92,138,92,230,2021-02-15T00:00:00,2497,2497,1204,3701
ΡΟΔΟΠΗΣ,106,51,93,-46,144,2021-02-15T00:00:00,2155,2155,854,3009
ΡΟΔΟΥ,1211,74,153,95,227,2021-02-15T00:00:00,2586,2586,1032,3618
ΣΑΜΟΥ,1104,25,43,26,68,2021-02-15T00:00:00,916,916,472,1388
ΣΕΡΡΩΝ,206,232,141,151,373,2021-02-15T00:00:00,3512,3512,1441,4953
ΣΠΟΡΑΔΩΝ,504,6,0,0,6,2021-02-15T00:00:00,245,245,7,252
ΣΥΡΟΥ,1212,0,54,6,54,2021-02-15T00:00:00,875,875,440,1315
ΤΗΝΟΥ,1213,0,0,0,0,2021-02-15T00:00:00,280,280,1,281
ΤΡΙΚΑΛΩΝ,505,190,196,20,386,2021-02-15T00:00:00,4591,4591,1916,6507
ΦΘΙΩΤΙΔΑΣ,804,119,222,71,341,2021-02-15T00:00:00,3560,3560,1785,5345
ΦΛΩΡΙΝΑΣ,304,53,80,37,133,2021-02-15T00:00:00,1713,1713,752,2465
ΦΩΚΙΔΑΣ,805,37,50,23,87,2021-02-15T00:00:00,1012,1012,439,1451
ΧΑΛΚΙΔΙΚΗΣ,207,81,100,51,181,2021-02-15T00:00:00,2468,2468,869,3337
ΧΑΝΙΩΝ,1304,164,276,62,440,2021-02-15T00:00:00,6888,6888,2771,9659
ΧΙΟΥ,1105,84,42,31,126,2021-02-15T00:00:00,1837,1837,574,2411
ΑΙΤΩΛΟΑΚΑΡΝΑΝΙΑΣ,701,259,160,-27,419,2021-02-16T00:00:00,4432,4432,1597,6029
ΑΝΑΤΟΛΙΚΗΣ ΑΤΤΙΚΗΣ,901,149,157,-335,306,2021-02-16T00:00:00,9834,9834,2590,12424
ΑΝΔΡΟΥ,1201,0,0,0,0,2021-02-16T00:00:00,263,263,1,264
ΑΡΓΟΛΙΔΑΣ,1001,159,116,27,275,2021-02-16T00:00:00,3142,3142,1407,4549
ΑΡΚΑΔΙΑΣ,1002,135,118,-6,253,2021-02-16T00:00:00,3014,3014,1432,4446
ΑΡΤΑΣ,401,69,126,-13,195,2021-02-16T00:00:00,3128,3128,1499,4627
ΑΧΑΪΑΣ,702,244,238,-133,482,2021-02-16T00:00:00,10090,10090,4911,15001
ΒΟΙΩΤΙΑΣ,801,171,94,87,265,2021-02-16T00:00:00,2936,2936,1205,4141
ΒΟΡΕΙΟΥ ΤΟΜΕΑ ΑΘΗΝΩΝ,902,1048,1000,-3039,2048,2021-02-16T00:00:00,48309,48309,26224,74533
ΓΡΕΒΕΝΩΝ,301,54,50,41,104,2021-02-16T00:00:00,1230,1230,552,1782
ΔΡΑΜΑΣ,101,85,138,22,223,2021-02-16T00:00:00,3268,3268,1439,4707
ΔΥΤΙΚΗΣ ΑΤΤΙΚΗΣ,903,20,52,-117,72,2021-02-16T00:00:00,3090,3090,1487,4577
ΔΥΤΙΚΟΥ ΤΟΜΕΑ ΑΘΗΝΩΝ,904,215,131,-707,346,2021-02-16T00:00:00,17548,17548,6226,23774
ΕΒΡΟΥ,102,188,217,10,405,2021-02-16T00:00:00,5544,5544,2997,8541
ΕΥΒΟΙΑΣ,802,153,237,59,390,2021-02-16T00:00:00,5969,5969,2688,8657
ΕΥΡΥΤΑΝΙΑΣ,803,32,15,10,47,2021-02-16T00:00:00,694,694,369,1063
ΖΑΚΥΝΘΟΥ,601,11,43,-48,54,2021-02-16T00:00:00,1317,1317,732,2049
ΗΛΕΙΑΣ,703,93,152,-43,245,2021-02-16T00:00:00,3875,3875,1807,5682
ΗΜΑΘΙΑΣ,201,197,167,56,364,2021-02-16T00:00:00,4522,4522,1801,6323
ΗΡΑΚΛΕΙΟΥ,1301,319,277,-79,596,2021-02-16T00:00:00,9777,9777,5831,15608
ΘΑΣΟΥ,103,0,0,0,0,2021-02-16T00:00:00,415,415,16,431
ΘΕΣΠΡΩΤΙΑΣ,402,42,112,-18,154,2021-02-16T00:00:00,2244,2244,1045,3289
ΘΕΣΣΑΛΟΝΙΚΗΣ,202,1923,1052,-49,2975,2021-02-16T00:00:00,44541,44541,20617,65158
ΘΗΡΑΣ,1202,0,2,-32,2,2021-02-16T00:00:00,370,370,151,521
ΙΘΑΚΗΣ,602,0,0,0,0,2021-02-16T00:00:00,77,77,0,77
ΙΚΑΡΙΑΣ,1101,0,7,-22,7,2021-02-16T00:00:00,690,690,179,869
ΙΩΑΝΝΙΝΩΝ,403,281,198,-79,479,2021-02-16T00:00:00,8067,8067,4654,12721
ΚΑΒΑΛΑΣ,104,110,188,-4,298,2021-02-16T00:00:00,4391,4391,1911,6302
ΚΑΛΥΜΝΟΥ,1203,9,2,-39,11,2021-02-16T00:00:00,707,707,379,1086
ΚΑΡΔΙΤΣΑΣ,501,267,79,-6,346,2021-02-16T00:00:00,4379,4379,1827,6206
ΚΑΡΠΑΘΟΥ,1204,4,14,0,18,2021-02-16T00:00:00,261,261,120,381
ΚΑΣΤΟΡΙΑΣ,302,65,100,32,165,2021-02-16T00:00:00,2090,2090,900,2990
ΚΕΑΣ-ΚΥΘΝΟΥ,1205,8,0,-5,8,2021-02-16T00:00:00,39,39,0,39
ΚΕΝΤΡΙΚΟΥ ΤΟΜΕΑ ΑΘΗΝΩΝ,905,1108,392,-1715,1500,2021-02-16T00:00:00,63258,63258,28355,91613
ΚΕΡΚΥΡΑΣ,603,97,135,-98,232,2021-02-16T00:00:00,3333,3333,1710,5043
ΚΕΦΑΛΛΗΝΙΑΣ,604,0,0,-90,0,2021-02-16T00:00:00,1647,1647,878,2525
ΚΙΛΚΙΣ,203,54,108,-30,162,2021-02-16T00:00:00,3077,3077,1329,4406
ΚΟΖΑΝΗΣ,303,238,97,17,335,2021-02-16T00:00:00,4785,4785,1692,6477
ΚΟΡΙΝΘΙΑΣ,1003,235,105,30,340,2021-02-16T00:00:00,3345,3345,1025,4370
ΚΩ,1206,40,36,-14,76,2021-02-16T00:00:00,1010,1010,463,1473
ΛΑΚΩΝΙΑΣ,1004,138,145,21,283,2021-02-16T00:00:00,3098,3098,1496,4594
ΛΑΡΙΣΑΣ,502,565,204,70,769,2021-02-16T00:00:00,8475,8475,3660,12135
ΛΑΣΙΘΙΟΥ,1302,70,192,3,262,2021-02-16T00:00:00,4060,4060,2072,6132
ΛΕΣΒΟΥ,1102,39,105,-58,144,2021-02-16T00:00:00,2648,2648,1317,3965
ΛΕΥΚΑΔΑΣ,605,45,56,-8,101,2021-02-16T00:00:00,1503,1503,514,2017
ΛΗΜΝΟΥ,1103,11,31,0,42,2021-02-16T00:00:00,783,783,415,1198
ΜΑΓΝΗΣΙΑΣ,503,178,216,68,394,2021-02-16T00:00:00,4766,4766,1625,6391
ΜΕΣΣΗΝΙΑΣ,1005,166,278,32,444,2021-02-16T00:00:00,5192,5192,2181,7373
ΜΗΛΟΥ,1207,0,0,0,0,2021-02-16T00:00:00,230,230,2,232
ΜΥΚΟΝΟΥ,1208,0,0,0,0,2021-02-16T00:00:00,144,144,0,144
ΝΑΞΟΥ,1209,0,23,-1,23,2021-02-16T00:00:00,445,445,213,658
ΝΗΣΩΝ,906,26,0,-18,26,2021-02-16T00:00:00,1697,1697,150,1847
ΝΟΤΙΟΥ ΤΟΜΕΑ ΑΘΗΝΩΝ,907,333,85,-329,418,2021-02-16T00:00:00,8690,8690,2969,11659
ΞΑΝΘΗΣ,105,45,96,6,141,2021-02-16T00:00:00,2420,2420,1297,3717
ΠΑΡΟΥ,1210,0,0,0,0,2021-02-16T00:00:00,290,290,4,294
ΠΕΙΡΑΙΩΣ,908,124,179,-727,303,2021-02-16T00:00:00,15174,15174,6383,21557
ΠΕΛΛΑΣ,204,204,121,-29,325,2021-02-16T00:00:00,5522,5522,1773,7295
ΠΙΕΡΙΑΣ,205,121,117,22,238,2021-02-16T00:00:00,4011,4011,1270,5281
ΠΡΕΒΕΖΑΣ,404,133,57,25,190,2021-02-16T00:00:00,1338,1338,772,2110
ΡΕΘΥΜΝΟΥ,1303,110,110,-10,220,2021-02-16T00:00:00,2607,2607,1314,3921
ΡΟΔΟΠΗΣ,106,94,101,51,195,2021-02-16T00:00:00,2249,2249,955,3204
ΡΟΔΟΥ,1211,26,119,-82,145,2021-02-16T00:00:00,2612,2612,1151,3763
ΣΑΜΟΥ,1104,40,36,8,76,2021-02-16T00:00:00,956,956,508,1464
ΣΕΡΡΩΝ,206,303,141,71,444,2021-02-16T00:00:00,3815,3815,1582,5397
ΣΠΟΡΑΔΩΝ,504,0,0,-6,0,2021-02-16T00:00:00,245,245,7,252
ΣΥΡΟΥ,1212,0,0,-54,0,2021-02-16T00:00:00,875,875,440,1315
ΤΗΝΟΥ,1213,0,0,0,0,2021-02-16T00:00:00,280,280,1,281
ΤΡΙΚΑΛΩΝ,505,285,128,27,413,2021-02-16T00:00:00,4876,4876,2044,6920
ΦΘΙΩΤΙΔΑΣ,804,139,160,-42,299,2021-02-16T00:00:00,3699,3699,1945,5644
ΦΛΩΡΙΝΑΣ,304,40,41,-52,81,2021-02-16T00:00:00,1753,1753,793,2546
ΦΩΚΙΔΑΣ,805,63,51,27,114,2021-02-16T00:00:00,1075,1075,490,1565
ΧΑΛΚΙΔΙΚΗΣ,207,139,86,44,225,2021-02-16T00:00:00,2607,2607,955,3562
ΧΑΝΙΩΝ,1304,185,193,-62,378,2021-02-16T00:00:00,7073,7073,2964,10037
ΧΙΟΥ,1105,87,44,5,131,2021-02-16T00:00:00,1924,1924,618,2542
ΑΙΤΩΛΟΑΚΑΡΝΑΝΙΑΣ,701,250,153,-16,403,2021-02-17T00:00:00,4682,4682,1750,6432
ΑΝΑΤΟΛΙΚΗΣ ΑΤΤΙΚΗΣ,901,442,415,551,857,2021-02-17T00:00:00,10276,10276,3005,13281
ΑΝΔΡΟΥ,1201,0,0,0,0,2021-02-17T00:00:00,263,263,1,264
ΑΡΓΟΛΙΔΑΣ,1001,126,152,3,278,2021-02-17T00:00:00,3268,3268,1559,4827
ΑΡΚΑΔΙΑΣ,1002,120,133,0,253,2021-02-17T00:00:00,3134,3134,1565,4699
ΑΡΤΑΣ,401,90,99,-6,189,2021-02-17T00:00:00,3218,3218,1598,4816
ΑΧΑΪΑΣ,702,199,340,57,539,2021-02-17T00:00:00,10289,10289,5251,15540
ΒΟΙΩΤΙΑΣ,801,255,164,154,419,2021-02-17T00:00:00,3191,3191,1369,4560
ΒΟΡΕΙΟΥ ΤΟΜΕΑ ΑΘΗΝΩΝ,902,2762,1047,1761,3809,2021-02-17T00:00:00,51071,51071,27271,78342
ΓΡΕΒΕΝΩΝ,301,43,43,-18,86,2021-02-17T00:00:00,1273,1273,595,1868
ΔΡΑΜΑΣ,101,62,147,-14,209,2021-02-17T00:00:00,3330,3330,1586,4916
ΔΥΤΙΚΗΣ ΑΤΤΙΚΗΣ,903,75,171,174,246,2021-02-17T00:00:00,3165,3165,1658,4823
ΔΥΤΙΚΟΥ ΤΟΜΕΑ ΑΘΗΝΩΝ,904,342,552,548,894,2021-02-17T00:00:00,17890,17890,6778,24668
ΕΒΡΟΥ,102,179,241,15,420,2021-02-17T00:00:00,5723,5723,3238,8961
ΕΥΒΟΙΑΣ,802,170,253,33,423,2021-02-17T00:00:00,6139,6139,2941,9080
ΕΥΡΥΤΑΝΙΑΣ,803,18,33,4,51,2021-02-17T00:00:00,712,712,402,1114
ΖΑΚΥΝΘΟΥ,601,14,65,25,79,2021-02-17T00:00:00,1331,1331,797,2128
ΗΛΕΙΑΣ,703,91,207,53,298,2021-02-17T00:00:00,3966,3966,2014,5980
ΗΜΑΘΙΑΣ,201,207,136,-21,343,2021-02-17T00:00:00,4729,4729,1937,6666
ΗΡΑΚΛΕΙΟΥ,1301,295,336,35,631,2021-02-17T00:00:00,10072,10072,6167,16239
ΘΑΣΟΥ,103,0,0,0,0,2021-02-17T00:00:00,415,415,16,431
ΘΕΣΠΡΩΤΙΑΣ,402,43,98,-13,141,2021-02-17T00:00:00,2287,2287,1143,3430
ΘΕΣΣΑΛΟΝΙΚΗΣ,202,2072,1296,393,3368,2021-02-17T00:00:00,46613,46613,21913,68526
ΘΗΡΑΣ,1202,0,0,-2,0,2021-02-17T00:00:00,370,370,151,521
ΙΘΑΚΗΣ,602,0,0,0,0,2021-02-17T00:00:00,77,77,0,77
ΙΚΑΡΙΑΣ,1101,0,0,-7,0,2021-02-17T00:00:00,690,690,179,869
ΙΩΑΝΝΙΝΩΝ,403,284,207,12,491,2021-02-17T00:00:00,8351,8351,4861,13212
ΚΑΒΑΛΑΣ,104,101,205,8,306,2021-02-17T00:00:00,4492,4492,2116,6608
ΚΑΛΥΜΝΟΥ,1203,0,0,-11,0,2021-02-17T00:00:00,707,707,379,1086
ΚΑΡΔΙΤΣΑΣ,501,288,130,72,418,2021-02-17T00:00:00,4667,4667,1957,6624
ΚΑΡΠΑΘΟΥ,1204,0,0,-18,0,2021-02-17T00:00:00,261,261,120,381
ΚΑΣΤΟΡΙΑΣ,302,48,93,-24,141,2021-02-17T00:00:00,2138,2138,993,3131
ΚΕΑΣ-ΚΥΘΝΟΥ,1205,0,0,-8,0,2021-02-17T00:00:00,39,39,0,39
ΚΕΝΤΡΙΚΟΥ ΤΟΜΕΑ ΑΘΗΝΩΝ,905,1811,1474,1785,3285,2021-02-17T00:00:00,65069,65069,29829,94898
ΚΕΡΚΥΡΑΣ,603,65,130,-37,195,2021-02-17T00:00:00,3398,3398,1840,5238
ΚΕΦΑΛΛΗΝΙΑΣ,604,37,54,91,91,2021-02-17T00:00:00,1684,1684,932,2616
ΚΙΛΚΙΣ,203,49,137,24,186,2021-02-17T00:00:00,3126,3126,1466,4592
ΚΟΖΑΝΗΣ,303,211,120,-4,331,2021-02-17T00:00:00,4996,4996,1812,6808
ΚΟΡΙΝΘΙΑΣ,1003,209,114,-17,323,2021-02-17T00:00:00,3554,3554,1139,4693
ΚΩ,1206,40,41,5,81,2021-02-17T00:00:00,1050,1050,504,1554
ΛΑΚΩΝΙΑΣ,1004,147,127,-9,274,2021-02-17T00:00:00,3245,3245,1623,4868
ΛΑΡΙΣΑΣ,502,489,203,-77,692,2021-02-17T00:00:00,8964,8964,3863,12827
ΛΑΣΙΘΙΟΥ,1302,52,249,39,301,2021-02-17T00:00:00,4112,4112,2321,6433
ΛΕΣΒΟΥ,1102,42,135,33,177,2021-02-17T00:00:00,2690,2690,1452,4142
ΛΕΥΚΑΔΑΣ,605,42,50,-9,92,2021-02-17T00:00:00,1545,1545,564,2109
ΛΗΜΝΟΥ,1103,0,0,-42,0,2021-02-17T00:00:00,783,783,415,1198
ΜΑΓΝΗΣΙΑΣ,503,176,270,52,446,2021-02-17T00:00:00,4942,4942,1895,6837
ΜΕΣΣΗΝΙΑΣ,1005,203,252,11,455,2021-02-17T00:00:00,5395,5395,2433,7828
ΜΗΛΟΥ,1207,0,0,0,0,2021-02-17T00:00:00,230,230,2,232
ΜΥΚΟΝΟΥ,1208,0,0,0,0,2021-02-17T00:00:00,144,144,0,144
ΝΑΞΟΥ,1209,0,0,-23,0,2021-02-17T00:00:00,445,445,213,658
ΝΗΣΩΝ,906,24,19,17,43,2021-02-17T00:00:00,1721,1721,169,1890
ΝΟΤΙΟΥ ΤΟΜΕΑ ΑΘΗΝΩΝ,907,422,178,182,600,2021-02-17T00:00:00,9112,9112,3147,12259
ΞΑΝΘΗΣ,105,58,96,13,154,2021-02-17T00:00:00,2478,2478,1393,3871
ΠΑΡΟΥ,1210,0,0,0,0,2021-02-17T00:00:00,290,290,4,294
ΠΕΙΡΑΙΩΣ,908,584,623,904,1207,2021-02-17T00:00:00,15758,15758,7006,22764
ΠΕΛΛΑΣ,204,187,200,62,387,2021-02-17T00:00:00,5709,5709,1973,7682
ΠΙΕΡΙΑΣ,205,109,119,-10,228,2021-02-17T00:00:00,4120,4120,1389,5509
ΠΡΕΒΕΖΑΣ,404,129,44,-17,173,2021-02-17T00:00:00,1467,1467,816,2283
ΡΕΘΥΜΝΟΥ,1303,92,122,-6,214,2021-02-17T00:00:00,2699,2699,1436,4135
ΡΟΔΟΠΗΣ,106,93,91,-11,184,2021-02-17T00:00:00,2342,2342,1046,3388
ΡΟΔΟΥ,1211,83,132,70,215,2021-02-17T00:00:00,2695,2695,1283,3978
ΣΑΜΟΥ,1104,38,1,-37,39,2021-02-17T00:00:00,994,994,509,1503
ΣΕΡΡΩΝ,206,279,153,-12,432,2021-02-17T00:00:00,4094,4094,1735,5829
ΣΠΟΡΑΔΩΝ,504,0,0,0,0,2021-02-17T00:00:00,245,245,7,252
ΣΥΡΟΥ,1212,0,0,0,0,2021-02-17T00:00:00,875,875,440,1315
ΤΗΝΟΥ,1213,0,0,0,0,2021-02-17T00:00:00,280,280,1,281
ΤΡΙΚΑΛΩΝ,505,280,119,-14,399,2021-02-17T00:00:00,5156,5156,2163,7319
ΦΘΙΩΤΙΔΑΣ,804,141,202,44,343,2021-02-17T00:00:00,3840,3840,2147,5987
ΦΛΩΡΙΝΑΣ,304,46,131,96,177,2021-02-17T00:00:00,1799,1799,924,2723
ΦΩΚΙΔΑΣ,805,44,55,-15,99,2021-02-17T00:00:00,1119,1119,545,1664
ΧΑΛΚΙΔΙΚΗΣ,207,136,143,54,279,2021-02-17T00:00:00,2743,2743,1098,3841
ΧΑΝΙΩΝ,1304,154,228,4,382,2021-02-17T00:00:00,7227,7227,3192,10419
ΧΙΟΥ,1105,82,43,-6,125,2021-02-17T00:00:00,2006,2006,661,2667
ΑΙΤΩΛΟΑΚΑΡΝΑΝΙΑΣ,701,292,119,8,411,2021-02-18T00:00:00,4974,4974,1869,6843
ΑΝΑΤΟΛΙΚΗΣ ΑΤΤΙΚΗΣ,901,494,416,53,910,2021-02-18T00:00:00,10770,10770,3421,14191
ΑΝΔΡΟΥ,1201,9,39,48,48,2021-02-18T00:00:00,272,272,40,312
ΑΡΓΟΛΙΔΑΣ,1001,124,134,-20,258,2021-02-18T00:00:00,3392,3392,1693,5085
ΑΡΚΑΔΙΑΣ,1002,131,94,-28,225,2021-02-18T00:00:00,3265,3265,1659,4924
ΑΡΤΑΣ,401,97,83,-9,180,2021-02-18T00:00:00,3315,3315,1681,4996
ΑΧΑΪΑΣ,702,251,307,19,558,2021-02-18T00:00:00,10540,10540,5558,16098
ΒΟΙΩΤΙΑΣ,801,282,176,39,458,2021-02-18T00:00:00,3473,3473,1545,5018
ΒΟΡΕΙΟΥ ΤΟΜΕΑ ΑΘΗΝΩΝ,902,3241,892,324,4133,2021-02-18T00:00:00,54312,54312,28163,82475
ΓΡΕΒΕΝΩΝ,301,25,47,-14,72,2021-02-18T00:00:00,1298,1298,642,1940
ΔΡΑΜΑΣ,101,79,149,19,228,2021-02-18T00:00:00,3409,3409,1735,5144
ΔΥΤΙΚΗΣ ΑΤΤΙΚΗΣ,903,144,151,49,295,2021-02-18T00:00:00,3309,3309,1809,5118
ΔΥΤΙΚΟΥ ΤΟΜΕΑ ΑΘΗΝΩΝ,904,353,701,160,1054,2021-02-18T00:00:00,18243,18243,7479,25722
ΕΒΡΟΥ,102,205,223,8,428,2021-02-18T00:00:00,5928,5928,3461,9389
ΕΥΒΟΙΑΣ,802,201,419,197,620,2021-02-18T00:00:00,6340,6340,3360,9700
ΕΥΡΥΤΑΝΙΑΣ,803,23,37,9,60,2021-02-18T00:00:00,735,735,439,1174
ΖΑΚΥΝΘΟΥ,601,23,55,-1,78,2021-02-18T00:00:00,1354,1354,852,2206
ΗΛΕΙΑΣ,703,121,130,-47,251,2021-02-18T00:00:00,4087,4087,2144,6231
ΗΜΑΘΙΑΣ,201,199,156,12,355,2021-02-18T00:00:00,4928,4928,2093,7021
ΗΡΑΚΛΕΙΟΥ,1301,335,336,40,671,2021-02-18T00:00:00,10407,10407,6503,16910
ΘΑΣΟΥ,103,2,40,42,42,2021-02-18T00:00:00,417,417,56,473
ΘΕΣΠΡΩΤΙΑΣ,402,58,54,-29,112,2021-02-18T00:00:00,2345,2345,1197,3542
ΘΕΣΣΑΛΟΝΙΚΗΣ,202,2435,1047,114,3482,2021-02-18T00:00:00,49048,49048,22960,72008
ΘΗΡΑΣ,1202,1,35,36,36,2021-02-18T00:00:00,371,371,186,557
ΙΘΑΚΗΣ,602,0,0,0,0,2021-02-18T00:00:00,77,77,0,77
ΙΚΑΡΙΑΣ,1101,10,35,45,45,2021-02-18T00:00:00,700,700,214,914
ΙΩΑΝΝΙΝΩΝ,403,277,160,-54,437,2021-02-18T00:00:00,8628,8628,5021,13649
ΚΑΒΑΛΑΣ,104,115,200,9,315,2021-02-18T00:00:00,4607,4607,2316,6923
ΚΑΛΥΜΝΟΥ,1203,5,103,108,108,2021-02-18T00:00:00,712,712,482,1194
ΚΑΡΔΙΤΣΑΣ,501,313,122,17,435,2021-02-18T00:00:00,4980,4980,2079,7059
ΚΑΡΠΑΘΟΥ,1204,0,0,0,0,2021-02-18T00:00:00,261,261,120,381
ΚΑΣΤΟΡΙΑΣ,302,62,86,7,148,2021-02-18T00:00:00,2200,2200,1079,3279
ΚΕΑΣ-ΚΥΘΝΟΥ,1205,5,0,5,5,2021-02-18T00:00:00,44,44,0,44
ΚΕΝΤΡΙΚΟΥ ΤΟΜΕΑ ΑΘΗΝΩΝ,905,1974,1653,342,3627,2021-02-18T00:00:00,67043,67043,31482,98525
ΚΕΡΚΥΡΑΣ,603,79,87,-29,166,2021-02-18T00:00:00,3477,3477,1927,5404
ΚΕΦΑΛΛΗΝΙΑΣ,604,101,185,195,286,2021-02-18T00:00:00,1785,1785,1117,2902
ΚΙΛΚΙΣ,203,99,126,39,225,2021-02-18T00:00:00,3225,3225,1592,4817
ΚΟΖΑΝΗΣ,303,247,147,63,394,2021-02-18T00:00:00,5243,5243,1959,7202
ΚΟΡΙΝΘΙΑΣ,1003,199,126,2,325,2021-02-18T00:00:00,3753,3753,1265,5018
ΚΩ,1206,47,77,43,124,2021-02-18T00:00:00,1097,1097,581,1678
ΛΑΚΩΝΙΑΣ,1004,212,65,3,277,2021-02-18T00:00:00,3457,3457,1688,5145
ΛΑΡΙΣΑΣ,502,429,181,-82,610,2021-02-18T00:00:00,9393,9393,4044,13437
ΛΑΣΙΘΙΟΥ,1302,86,235,20,321,2021-02-18T00:00:00,4198,4198,2556,6754
ΛΕΣΒΟΥ,1102,64,113,0,177,2021-02-18T00:00:00,2754,2754,1565,4319
ΛΕΥΚΑΔΑΣ,605,49,51,8,100,2021-02-18T00:00:00,1594,1594,615,2209
ΛΗΜΝΟΥ,1103,0,30,30,30,2021-02-18T00:00:00,783,783,445,1228
ΜΑΓΝΗΣΙΑΣ,503,203,228,-15,431,2021-02-18T00:00:00,5145,5145,2123,7268
ΜΕΣΣΗΝΙΑΣ,1005,183,192,-80,375,2021-02-18T00:00:00,5578,5578,2625,8203
ΜΗΛΟΥ,1207,7,11,18,18,2021-02-18T00:00:00,237,237,13,250
ΜΥΚΟΝΟΥ,1208,10,33,43,43,2021-02-18T00:00:00,154,154,33,187
ΝΑΞΟΥ,1209,8,47,55,55,2021-02-18T00:00:00,453,453,260,713
ΝΗΣΩΝ,906,54,192,203,246,2021-02-18T00:00:00,1775,1775,361,2136
ΝΟΤΙΟΥ ΤΟΜΕΑ ΑΘΗΝΩΝ,907,485,380,265,865,2021-02-18T00:00:00,9597,9597,3527,13124
ΞΑΝΘΗΣ,105,72,112,30,184,2021-02-18T00:00:00,2550,2550,1505,4055
ΠΑΡΟΥ,1210,5,37,42,42,2021-02-18T00:00:00,295,295,41,336
ΠΕΙΡΑΙΩΣ,908,533,593,-81,1126,2021-02-18T00:00:00,16291,16291,7599,23890
ΠΕΛΛΑΣ,204,195,139,-53,334,2021-02-18T00:00:00,5904,5904,2112,8016
ΠΙΕΡΙΑΣ,205,102,161,35,263,2021-02-18T00:00:00,4222,4222,1550,5772
ΠΡΕΒΕΖΑΣ,404,148,18,-7,166,2021-02-18T00:00:00,1615,1615,834,2449
ΡΕΘΥΜΝΟΥ,1303,103,145,34,248,2021-02-18T00:00:00,2802,2802,1581,4383
ΡΟΔΟΠΗΣ,106,102,92,10,194,2021-02-18T00:00:00,2444,2444,1138,3582
ΡΟΔΟΥ,1211,73,110,-32,183,2021-02-18T00:00:00,2768,2768,1393,4161
ΣΑΜΟΥ,1104,50,70,81,120,2021-02-18T00:00:00,1044,1044,579,1623
ΣΕΡΡΩΝ,206,270,154,-8,424,2021-02-18T00:00:00,4364,4364,1889,6253
ΣΠΟΡΑΔΩΝ,504,0,0,0,0,2021-02-18T00:00:00,245,245,7,252
ΣΥΡΟΥ,1212,19,101,120,120,2021-02-18T00:00:00,894,894,541,1435
ΤΗΝΟΥ,1213,6,36,42,42,2021-02-18T00:00:00,286,286,37,323
ΤΡΙΚΑΛΩΝ,505,318,117,36,435,2021-02-18T00:00:00,5474,5474,2280,7754
ΦΘΙΩΤΙΔΑΣ,804,189,124,-30,313,2021-02-18T00:00:00,4029,4029,2271,6300
ΦΛΩΡΙΝΑΣ,304,60,87,-30,147,2021-02-18T00:00:00,1859,1859,1011,2870
ΦΩΚΙΔΑΣ,805,58,43,2,101,2021-02-18T00:00:00,1177,1177,588,1765
ΧΑΛΚΙΔΙΚΗΣ,207,160,102,-17,262,2021-02-18T00:00:00,2903,2903,1200,4103
ΧΑΝΙΩΝ,1304,171,219,8,390,2021-02-18T00:00:00,7398,7398,3411,10809
ΧΙΟΥ,1105,72,51,-2,123,2021-02-18T00:00:00,2078,2078,712,2790
ΑΙΤΩΛΟΑΚΑΡΝΑΝΙΑΣ,701,292,89,-30,381,2021-02-19T00:00:00,5266,5266,1958,7224
ΑΝΑΤΟΛΙΚΗΣ ΑΤΤΙΚΗΣ,901,350,460,-100,810,2021-02-19T00:00:00,11120,11120,3881,15001
ΑΝΔΡΟΥ,1201,7,35,-6,42,2021-02-19T00:00:00,279,279,75,354
ΑΡΓΟΛΙΔΑΣ,1001,146,56,-56,202,2021-02-19T00:00:00,3538,3538,1749,5287
ΑΡΚΑΔΙΑΣ,1002,142,68,-15,210,2021-02-19T00:00:00,3407,3407,1727,5134
ΑΡΤΑΣ,401,119,72,11,191,2021-02-19T00:00:00,3434,3434,1753,5187
ΑΧΑΪΑΣ,702,264,293,-1,557,2021-02-19T00:00:00,10804,10804,5851,16655
ΒΟΙΩΤΙΑΣ,801,267,108,-83,375,2021-02-19T00:00:00,3740,3740,1653,5393
ΒΟΡΕΙΟΥ ΤΟΜΕΑ ΑΘΗΝΩΝ,902,4288,1461,1616,5749,2021-02-19T00:00:00,58600,58600,29624,88224
ΓΡΕΒΕΝΩΝ,301,87,20,35,107,2021-02-19T00:00:00,1385,1385,662,2047
ΔΡΑΜΑΣ,101,141,68,-19,209,2021-02-19T00:00:00,3550,3550,1803,5353
ΔΥΤΙΚΗΣ ΑΤΤΙΚΗΣ,903,102,146,-47,248,2021-02-19T00:00:00,3411,3411,1955,5366
ΔΥΤΙΚΟΥ ΤΟΜΕΑ ΑΘΗΝΩΝ,904,391,552,-111,943,2021-02-19T00:00:00,18634,18634,8031,26665
ΕΒΡΟΥ,102,243,144,-41,387,2021-02-19T00:00:00,6171,6171,3605,9776
ΕΥΒΟΙΑΣ,802,274,280,-66,554,2021-02-19T00:00:00,6614,6614,3640,10254
ΕΥΡΥΤΑΝΙΑΣ,803,25,4,-31,29,2021-02-19T00:00:00,760,760,443,1203
ΖΑΚΥΝΘΟΥ,601,9,67,-2,76,2021-02-19T00:00:00,1363,1363,919,2282
ΗΛΕΙΑΣ,703,127,108,-16,235,2021-02-19T00:00:00,4214,4214,2252,6466
ΗΜΑΘΙΑΣ,201,241,125,11,366,2021-02-19T00:00:00,5169,5169,2218,7387
ΗΡΑΚΛΕΙΟΥ,1301,397,236,-38,633,2021-02-19T00:00:00,10804,10804,6739,17543
ΘΑΣΟΥ,103,3,45,6,48,2021-02-19T00:00:00,420,420,101,521
ΘΕΣΠΡΩΤΙΑΣ,402,51,25,-36,76,2021-02-19T00:00:00,2396,2396,1222,3618
ΘΕΣΣΑΛΟΝΙΚΗΣ,202,2309,951,-222,3260,2021-02-19T00:00:00,51357,51357,23911,75268
ΘΗΡΑΣ,1202,8,34,6,42,2021-02-19T00:00:00,379,379,220,599
ΙΘΑΚΗΣ,602,24,0,24,24,2021-02-19T00:00:00,101,101,0,101
ΙΚΑΡΙΑΣ,1101,26,12,-7,38,2021-02-19T00:00:00,726,726,226,952
ΙΩΑΝΝΙΝΩΝ,403,235,201,-1,436,2021-02-19T00:00:00,8863,8863,5222,14085
ΚΑΒΑΛΑΣ,104,153,110,-52,263,2021-02-19T00:00:00,4760,4760,2426,7186
ΚΑΛΥΜΝΟΥ,1203,6,34,-68,40,2021-02-19T00:00:00,718,718,516,1234
ΚΑΡΔΙΤΣΑΣ,501,309,104,-22,413,2021-02-19T00:00:00,5289,5289,2183,7472
ΚΑΡΠΑΘΟΥ,1204,7,47,54,54,2021-02-19T00:00:00,268,268,167,435
ΚΑΣΤΟΡΙΑΣ,302,89,69,10,158,2021-02-19T00:00:00,2289,2289,1148,3437
ΚΕΑΣ-ΚΥΘΝΟΥ,1205,0,0,-5,0,2021-02-19T00:00:00,44,44,0,44
ΚΕΝΤΡΙΚΟΥ ΤΟΜΕΑ ΑΘΗΝΩΝ,905,1994,1444,-189,3438,2021-02-19T00:00:00,69037,69037,32926,101963
ΚΕΡΚΥΡΑΣ,603,83,87,4,170,2021-02-19T00:00:00,3560,3560,2014,5574
ΚΕΦΑΛΛΗΝΙΑΣ,604,57,123,-106,180,2021-02-19T00:00:00,1842,1842,1240,3082
ΚΙΛΚΙΣ,203,91,35,-99,126,2021-02-19T00:00:00,3316,3316,1627,4943
ΚΟΖΑΝΗΣ,303,190,144,-60,334,2021-02-19T00:00:00,5433,5433,2103,7536
ΚΟΡΙΝΘΙΑΣ,1003,220,112,7,332,2021-02-19T00:00:00,3973,3973,1377,5350
ΚΩ,1206,44,37,-43,81,2021-02-19T00:00:00,1141,1141,618,1759
ΛΑΚΩΝΙΑΣ,1004,250,23,-4,273,2021-02-19T00:00:00,3707,3707,1711,5418
ΛΑΡΙΣΑΣ,502,565,143,98,708,2021-02-19T00:00:00,9958,9958,4187,14145
ΛΑΣΙΘΙΟΥ,1302,104,149,-68,253,2021-02-19T00:00:00,4302,4302,2705,7007
ΛΕΣΒΟΥ,1102,44,128,-5,172,2021-02-19T00:00:00,2798,2798,1693,4491
ΛΕΥΚΑΔΑΣ,605,58,53,11,111,2021-02-19T00:00:00,1652,1652,668,2320
ΛΗΜΝΟΥ,1103,2,41,13,43,2021-02-19T00:00:00,785,785,486,1271
ΜΑΓΝΗΣΙΑΣ,503,221,186,-24,407,2021-02-19T00:00:00,5366,5366,2309,7675
ΜΕΣΣΗΝΙΑΣ,1005,289,123,37,412,2021-02-19T00:00:00,5867,5867,2748,8615
ΜΗΛΟΥ,1207,53,6,41,59,2021-02-19T00:00:00,290,290,19,309
ΜΥΚΟΝΟΥ,1208,3,21,-19,24,2021-02-19T00:00:00,157,157,54,211
ΝΑΞΟΥ,1209,2,14,-39,16,2021-02-19T00:00:00,455,455,274,729
ΝΗΣΩΝ,906,32,156,-58,188,2021-02-19T00:00:00,1807,1807,517,2324
ΝΟΤΙΟΥ ΤΟΜΕΑ ΑΘΗΝΩΝ,907,485,315,-65,800,2021-02-19T00:00:00,10082,10082,3842,13924
ΞΑΝΘΗΣ,105,102,57,-25,159,2021-02-19T00:00:00,2652,2652,1562,4214
ΠΑΡΟΥ,1210,7,29,-6,36,2021-02-19T00:00:00,302,302,70,372
ΠΕΙΡΑΙΩΣ,908,568,373,-185,941,2021-02-19T00:00:00,16859,16859,7972,24831
ΠΕΛΛΑΣ,204,195,164,25,359,2021-02-19T00:00:00,6099,6099,2276,8375
ΠΙΕΡΙΑΣ,205,92,139,-32,231,2021-02-19T00:00:00,4314,4314,1689,6003
ΠΡΕΒΕΖΑΣ,404,173,7,14,180,2021-02-19T00:00:00,1788,1788,841,2629
ΡΕΘΥΜΝΟΥ,1303,113,106,-29,219,2021-02-19T00:00:00,2915,2915,1687,4602
ΡΟΔΟΠΗΣ,106,136,53,-5,189,2021-02-19T00:00:00,2580,2580,1191,3771
ΡΟΔΟΥ,1211,103,237,157,340,2021-02-19T00:00:00,2871,2871,1630,4501
ΣΑΜΟΥ,1104,46,35,-39,81,2021-02-19T00:00:00,1090,1090,614,1704
ΣΕΡΡΩΝ,206,361,54,-9,415,2021-02-19T00:00:00,4725,4725,1943,6668
ΣΠΟΡΑΔΩΝ,504,6,54,60,60,2021-02-19T00:00:00,251,251,61,312
ΣΥΡΟΥ,1212,2,40,-78,42,2021-02-19T00:00:00,896,896,581,1477
ΤΗΝΟΥ,1213,7,41,6,48,2021-02-19T00:00:00,293,293,78,371
ΤΡΙΚΑΛΩΝ,505,332,105,2,437,2021-02-19T00:00:00,5806,5806,2385,8191
ΦΘΙΩΤΙΔΑΣ,804,218,81,-14,299,2021-02-19T00:00:00,4247,4247,2352,6599
ΦΛΩΡΙΝΑΣ,304,91,46,-10,137,2021-02-19T00:00:00,1950,1950,1057,3007
ΦΩΚΙΔΑΣ,805,118,6,23,124,2021-02-19T00:00:00,1295,1295,594,1889
ΧΑΛΚΙΔΙΚΗΣ,207,162,102,2,264,2021-02-19T00:00:00,3065,3065,1302,4367
ΧΑΝΙΩΝ,1304,157,209,-24,366,2021-02-19T00:00:00,7555,7555,3620,11175
ΧΙΟΥ,1105,41,59,-23,100,2021-02-19T00:00:00,2119,2119,771,2890
ΑΙΤΩΛΟΑΚΑΡΝΑΝΙΑΣ,701,282,99,0,381,2021-02-20T00:00:00,5548,5548,2057,7605
ΑΝΑΤΟΛΙΚΗΣ ΑΤΤΙΚΗΣ,901,297,455,-58,752,2021-02-20T00:00:00,11417,11417,4336,15753
ΑΝΔΡΟΥ,1201,10,37,5,47,2021-02-20T00:00:00,289,289,112,401
ΑΡΓΟΛΙΔΑΣ,1001,151,59,8,210,2021-02-20T00:00:00,3689,3689,1808,5497
ΑΡΚΑΔΙΑΣ,1002,148,74,12,222,2021-02-20T00:00:00,3555,3555,1801,5356
ΑΡΤΑΣ,401,117,69,-5,186,2021-02-20T00:00:00,3551,3551,1822,5373
ΑΧΑΪΑΣ,702,231,428,102,659,2021-02-20T00:00:00,11035,11035,6279,17314
ΒΟΙΩΤΙΑΣ,801,270,103,-2,373,2021-02-20T00:00:00,4010,4010,1756,5766
ΒΟΡΕΙΟΥ ΤΟΜΕΑ ΑΘΗΝΩΝ,902,2890,963,-1896,3853,2021-02-20T00:00:00,61490,61490,30587,92077
ΓΡΕΒΕΝΩΝ,301,97,9,-1,106,2021-02-20T00:00:00,1482,1482,671,2153
ΔΡΑΜΑΣ,101,149,49,-11,198,2021-02-20T00:00:00,3699,3699,1852,5551
ΔΥΤΙΚΗΣ ΑΤΤΙΚΗΣ,903,95,212,59,307,2021-02-20T00:00:00,3506,3506,2167,5673
ΔΥΤΙΚΟΥ ΤΟΜΕΑ ΑΘΗΝΩΝ,904,374,559,-10,933,2021-02-20T00:00:00,19008,19008,8590,27598
ΕΒΡΟΥ,102,297,103,13,400,2021-02-20T00:00:00,6468,6468,3708,10176
ΕΥΒΟΙΑΣ,802,244,305,-5,549,2021-02-20T00:00:00,6858,6858,3945,10803
ΕΥΡΥΤΑΝΙΑΣ,803,29,5,5,34,2021-02-20T00:00:00,789,789,448,1237
ΖΑΚΥΝΘΟΥ,601,7,64,-5,71,2021-02-20T00:00:00,1370,1370,983,2353
ΗΛΕΙΑΣ,703,121,144,30,265,2021-02-20T00:00:00,4335,4335,2396,6731
ΗΜΑΘΙΑΣ,201,251,88,-27,339,2021-02-20T00:00:00,5420,5420,2306,7726
ΗΡΑΚΛΕΙΟΥ,1301,338,266,-29,604,2021-02-20T00:00:00,11142,11142,7005,18147
ΘΑΣΟΥ,103,0,48,0,48,2021-02-20T00:00:00,420,420,149,569
ΘΕΣΠΡΩΤΙΑΣ,402,51,43,18,94,2021-02-20T00:00:00,2447,2447,1265,3712
ΘΕΣΣΑΛΟΝΙΚΗΣ,202,2172,1156,68,3328,2021-02-20T00:00:00,53529,53529,25067,78596
ΘΗΡΑΣ,1202,0,24,-18,24,2021-02-20T00:00:00,379,379,244,623
ΙΘΑΚΗΣ,602,18,0,-6,18,2021-02-20T00:00:00,119,119,0,119
ΙΚΑΡΙΑΣ,1101,7,42,11,49,2021-02-20T00:00:00,733,733,268,1001
ΙΩΑΝΝΙΝΩΝ,403,224,168,-44,392,2021-02-20T00:00:00,9087,9087,5390,14477
ΚΑΒΑΛΑΣ,104,141,91,-31,232,2021-02-20T00:00:00,4901,4901,2517,7418
ΚΑΛΥΜΝΟΥ,1203,3,50,13,53,2021-02-20T00:00:00,721,721,566,1287
ΚΑΡΔΙΤΣΑΣ,501,233,210,30,443,2021-02-20T00:00:00,5522,5522,2393,7915
ΚΑΡΠΑΘΟΥ,1204,3,19,-32,22,2021-02-20T00:00:00,271,271,186,457
ΚΑΣΤΟΡΙΑΣ,302,91,49,-18,140,2021-02-20T00:00:00,2380,2380,1197,3577
ΚΕΑΣ-ΚΥΘΝΟΥ,1205,0,0,0,0,2021-02-20T00:00:00,44,44,0,44
ΚΕΝΤΡΙΚΟΥ ΤΟΜΕΑ ΑΘΗΝΩΝ,905,1732,1711,5,3443,2021-02-20T00:00:00,70769,70769,34637,105406
ΚΕΡΚΥΡΑΣ,603,76,97,3,173,2021-02-20T00:00:00,3636,3636,2111,5747
ΚΕΦΑΛΛΗΝΙΑΣ,604,36,122,-22,158,2021-02-20T00:00:00,1878,1878,1362,3240
ΚΙΛΚΙΣ,203,90,123,87,213,2021-02-20T00:00:00,3406,3406,1750,5156
ΚΟΖΑΝΗΣ,303,189,152,7,341,2021-02-20T00:00:00,5622,5622,2255,7877
ΚΟΡΙΝΘΙΑΣ,1003,231,104,3,335,2021-02-20T00:00:00,4204,4204,1481,5685
ΚΩ,1206,125,72,116,197,2021-02-20T00:00:00,1266,1266,690,1956
ΛΑΚΩΝΙΑΣ,1004,240,65,32,305,2021-02-20T00:00:00,3947,3947,1776,5723
ΛΑΡΙΣΑΣ,502,433,273,-2,706,2021-02-20T00:00:00,10391,10391,4460,14851
ΛΑΣΙΘΙΟΥ,1302,73,167,-13,240,2021-02-20T00:00:00,4375,4375,2872,7247
ΛΕΣΒΟΥ,1102,41,148,17,189,2021-02-20T00:00:00,2839,2839,1841,4680
ΛΕΥΚΑΔΑΣ,605,46,51,-14,97,2021-02-20T00:00:00,1698,1698,719,2417
ΛΗΜΝΟΥ,1103,5,67,29,72,2021-02-20T00:00:00,790,790,553,1343
ΜΑΓΝΗΣΙΑΣ,503,224,252,69,476,2021-02-20T00:00:00,5590,5590,2561,8151
ΜΕΣΣΗΝΙΑΣ,1005,261,136,-15,397,2021-02-20T00:00:00,6128,6128,2884,9012
ΜΗΛΟΥ,1207,0,6,-53,6,2021-02-20T00:00:00,290,290,25,315
ΜΥΚΟΝΟΥ,1208,0,30,6,30,2021-02-20T00:00:00,157,157,84,241
ΝΑΞΟΥ,1209,1,37,22,38,2021-02-20T00:00:00,456,456,311,767
ΝΗΣΩΝ,906,34,201,47,235,2021-02-20T00:00:00,1841,1841,718,2559
ΝΟΤΙΟΥ ΤΟΜΕΑ ΑΘΗΝΩΝ,907,486,285,-29,771,2021-02-20T00:00:00,10568,10568,4127,14695
ΞΑΝΘΗΣ,105,96,69,6,165,2021-02-20T00:00:00,2748,2748,1631,4379
ΠΑΡΟΥ,1210,1,41,6,42,2021-02-20T00:00:00,303,303,111,414
ΠΕΙΡΑΙΩΣ,908,567,402,28,969,2021-02-20T00:00:00,17426,17426,8374,25800
ΠΕΛΛΑΣ,204,154,207,2,361,2021-02-20T00:00:00,6253,6253,2483,8736
ΠΙΕΡΙΑΣ,205,64,166,-1,230,2021-02-20T00:00:00,4378,4378,1855,6233
ΠΡΕΒΕΖΑΣ,404,165,1,-14,166,2021-02-20T00:00:00,1953,1953,842,2795
ΡΕΘΥΜΝΟΥ,1303,131,138,50,269,2021-02-20T00:00:00,3046,3046,1825,4871
ΡΟΔΟΠΗΣ,106,134,56,1,190,2021-02-20T00:00:00,2714,2714,1247,3961
ΡΟΔΟΥ,1211,330,183,173,513,2021-02-20T00:00:00,3201,3201,1813,5014
ΣΑΜΟΥ,1104,40,59,18,99,2021-02-20T00:00:00,1130,1130,673,1803
ΣΕΡΡΩΝ,206,357,61,3,418,2021-02-20T00:00:00,5082,5082,2004,7086
ΣΠΟΡΑΔΩΝ,504,23,67,30,90,2021-02-20T00:00:00,274,274,128,402
ΣΥΡΟΥ,1212,6,30,-6,36,2021-02-20T00:00:00,902,902,611,1513
ΤΗΝΟΥ,1213,5,49,6,54,2021-02-20T00:00:00,298,298,127,425
ΤΡΙΚΑΛΩΝ,505,273,145,-19,418,2021-02-20T00:00:00,6079,6079,2530,8609
ΦΘΙΩΤΙΔΑΣ,804,204,102,7,306,2021-02-20T00:00:00,4451,4451,2454,6905
ΦΛΩΡΙΝΑΣ,304,79,41,-17,120,2021-02-20T00:00:00,2029,2029,1098,3127
ΦΩΚΙΔΑΣ,805,75,9,-40,84,2021-02-20T00:00:00,1370,1370,603,1973
ΧΑΛΚΙΔΙΚΗΣ,207,167,69,-28,236,2021-02-20T00:00:00,3232,3232,1371,4603
ΧΑΝΙΩΝ,1304,143,282,59,425,2021-02-20T00:00:00,7698,7698,3902,11600
ΧΙΟΥ,1105,91,53,44,144,2021-02-20T00:00:00,2210,2210,824,3034
ΑΙΤΩΛΟΑΚΑΡΝΑΝΙΑΣ,701,0,0,-381,0,2021-02-21T00:00:00,5548,5548,2057,7605
ΑΝΑΤΟΛΙΚΗΣ ΑΤΤΙΚΗΣ,901,33,111,-608,144,2021-02-21T00:00:00,11450,11450,4447,15897
ΑΝΔΡΟΥ,1201,0,0,-47,0,2021-02-21T00:00:00,289,289,112,401
ΑΡΓΟΛΙΔΑΣ,1001,0,0,-210,0,2021-02-21T00:00:00,3689,3689,1808,5497
ΑΡΚΑΔΙΑΣ,1002,0,0,-222,0,2021-02-21T00:00:00,3555,3555,1801,5356
ΑΡΤΑΣ,401,0,0,-186,0,2021-02-21T00:00:00,3551,3551,1822,5373
ΑΧΑΪΑΣ,702,0,0,-659,0,2021-02-21T00:00:00,11035,11035,6279,17314
ΒΟΙΩΤΙΑΣ,801,0,0,-373,0,2021-02-21T00:00:00,4010,4010,1756,5766
ΒΟΡΕΙΟΥ ΤΟΜΕΑ ΑΘΗΝΩΝ,902,299,149,-3405,448,2021-02-21T00:00:00,61789,61789,30736,92525
ΓΡΕΒΕΝΩΝ,301,0,0,-106,0,2021-02-21T00:00:00,1482,1482,671,2153
ΔΡΑΜΑΣ,101,0,0,-198,0,2021-02-21T00:00:00,3699,3699,1852,5551
ΔΥΤΙΚΗΣ ΑΤΤΙΚΗΣ,903,0,0,-307,0,2021-02-21T00:00:00,3506,3506,2167,5673
ΔΥΤΙΚΟΥ ΤΟΜΕΑ ΑΘΗΝΩΝ,904,59,202,-672,261,2021-02-21T00:00:00,19067,19067,8792,27859
ΕΒΡΟΥ,102,0,0,-400,0,2021-02-21T00:00:00,6468,6468,3708,10176
ΕΥΒΟΙΑΣ,802,2,0,-547,2,2021-02-21T00:00:00,6860,6860,3945,10805
ΕΥΡΥΤΑΝΙΑΣ,803,0,0,-34,0,2021-02-21T00:00:00,789,789,448,1237
ΖΑΚΥΝΘΟΥ,601,0,0,-71,0,2021-02-21T00:00:00,1370,1370,983,2353
ΗΛΕΙΑΣ,703,0,0,-265,0,2021-02-21T00:00:00,4335,4335,2396,6731
ΗΜΑΘΙΑΣ,201,0,0,-339,0,2021-02-21T00:00:00,5420,5420,2306,7726
ΗΡΑΚΛΕΙΟΥ,1301,0,0,-604,0,2021-02-21T00:00:00,11142,11142,7005,18147
ΘΑΣΟΥ,103,0,0,-48,0,2021-02-21T00:00:00,420,420,149,569
ΘΕΣΠΡΩΤΙΑΣ,402,0,0,-94,0,2021-02-21T00:00:00,2447,2447,1265,3712
ΘΕΣΣΑΛΟΝΙΚΗΣ,202,0,0,-3328,0,2021-02-21T00:00:00,53529,53529,25067,78596
ΘΗΡΑΣ,1202,0,0,-24,0,2021-02-21T00:00:00,379,379,244,623
ΙΘΑΚΗΣ,602,0,0,-18,0,2021-02-21T00:00:00,119,119,0,119
ΙΚΑΡΙΑΣ,1101,0,0,-49,0,2021-02-21T00:00:00,733,733,268,1001
ΙΩΑΝΝΙΝΩΝ,403,0,0,-392,0,2021-02-21T00:00:00,9087,9087,5390,14477
ΚΑΒΑΛΑΣ,104,0,0,-232,0,2021-02-21T00:00:00,4901,4901,2517,7418
ΚΑΛΥΜΝΟΥ,1203,0,0,-53,0,2021-02-21T00:00:00,721,721,566,1287
ΚΑΡΔΙΤΣΑΣ,501,0,0,-443,0,2021-02-21T00:00:00,5522,5522,2393,7915
ΚΑΡΠΑΘΟΥ,1204,0,0,-22,0,2021-02-21T00:00:00,271,271,186,457
ΚΑΣΤΟΡΙΑΣ,302,0,0,-140,0,2021-02-21T00:00:00,2380,2380,1197,3577
ΚΕΑΣ-ΚΥΘΝΟΥ,1205,0,0,0,0,2021-02-21T00:00:00,44,44,0,44
ΚΕΝΤΡΙΚΟΥ ΤΟΜΕΑ ΑΘΗΝΩΝ,905,1048,1109,-1286,2157,2021-02-21T00:00:00,71817,71817,35746,107563
ΚΕΡΚΥΡΑΣ,603,0,0,-173,0,2021-02-21T00:00:00,3636,3636,2111,5747
ΚΕΦΑΛΛΗΝΙΑΣ,604,0,0,-158,0,2021-02-21T00:00:00,1878,1878,1362,3240
ΚΙΛΚΙΣ,203,0,0,-213,0,2021-02-21T00:00:00,3406,3406,1750,5156
ΚΟΖΑΝΗΣ,303,0,0,-341,0,2021-02-21T00:00:00,5622,5622,2255,7877
ΚΟΡΙΝΘΙΑΣ,1003,0,0,-335,0,2021-02-21T00:00:00,4204,4204,1481,5685
ΚΩ,1206,77,0,-120,77,2021-02-21T00:00:00,1343,1343,690,2033
ΛΑΚΩΝΙΑΣ,1004,0,0,-305,0,2021-02-21T00:00:00,3947,3947,1776,5723
ΛΑΡΙΣΑΣ,502,0,0,-706,0,2021-02-21T00:00:00,10391,10391,4460,14851
ΛΑΣΙΘΙΟΥ,1302,0,0,-240,0,2021-02-21T00:00:00,4375,4375,2872,7247
ΛΕΣΒΟΥ,1102,0,0,-189,0,2021-02-21T00:00:00,2839,2839,1841,4680
ΛΕΥΚΑΔΑΣ,605,0,0,-97,0,2021-02-21T00:00:00,1698,1698,719,2417
ΛΗΜΝΟΥ,1103,0,0,-72,0,2021-02-21T00:00:00,790,790,553,1343
ΜΑΓΝΗΣΙΑΣ,503,0,0,-476,0,2021-02-21T00:00:00,5590,5590,2561,8151
ΜΕΣΣΗΝΙΑΣ,1005,0,0,-397,0,2021-02-21T00:00:00,6128,6128,2884,9012
ΜΗΛΟΥ,1207,0,0,-6,0,2021-02-21T00:00:00,290,290,25,315
ΜΥΚΟΝΟΥ,1208,0,0,-30,0,2021-02-21T00:00:00,157,157,84,241
ΝΑΞΟΥ,1209,0,0,-38,0,2021-02-21T00:00:00,456,456,311,767
ΝΗΣΩΝ,906,0,0,-235,0,2021-02-21T00:00:00,1841,1841,718,2559
ΝΟΤΙΟΥ ΤΟΜΕΑ ΑΘΗΝΩΝ,907,13,155,-603,168,2021-02-21T00:00:00,10581,10581,4282,14863
ΞΑΝΘΗΣ,105,0,0,-165,0,2021-02-21T00:00:00,2748,2748,1631,4379
ΠΑΡΟΥ,1210,0,0,-42,0,2021-02-21T00:00:00,303,303,111,414
ΠΕΙΡΑΙΩΣ,908,203,261,-505,464,2021-02-21T00:00:00,17629,17629,8635,26264
ΠΕΛΛΑΣ,204,0,0,-361,0,2021-02-21T00:00:00,6253,6253,2483,8736
ΠΙΕΡΙΑΣ,205,0,0,-230,0,2021-02-21T00:00:00,4378,4378,1855,6233
ΠΡΕΒΕΖΑΣ,404,0,0,-166,0,2021-02-21T00:00:00,1953,1953,842,2795
ΡΕΘΥΜΝΟΥ,1303,0,0,-269,0,2021-02-21T00:00:00,3046,3046,1825,4871
ΡΟΔΟΠΗΣ,106,0,0,-190,0,2021-02-21T00:00:00,2714,2714,1247,3961
ΡΟΔΟΥ,1211,80,8,-425,88,2021-02-21T00:00:00,3281,3281,1821,5102
ΣΑΜΟΥ,1104,0,0,-99,0,2021-02-21T00:00:00,1130,1130,673,1803
ΣΕΡΡΩΝ,206,0,0,-418,0,2021-02-21T00:00:00,5082,5082,2004,7086
ΣΠΟΡΑΔΩΝ,504,0,0,-90,0,2021-02-21T00:00:00,274,274,128,402
ΣΥΡΟΥ,1212,0,0,-36,0,2021-02-21T00:00:00,902,902,611,1513
ΤΗΝΟΥ,1213,0,0,-54,0,2021-02-21T00:00:00,298,298,127,425
ΤΡΙΚΑΛΩΝ,505,0,0,-418,0,2021-02-21T00:00:00,6079,6079,2530,8609
ΦΘΙΩΤΙΔΑΣ,804,0,0,-306,0,2021-02-21T00:00:00,4451,4451,2454,6905
ΦΛΩΡΙΝΑΣ,304,0,0,-120,0,2021-02-21T00:00:00,2029,2029,1098,3127
ΦΩΚΙΔΑΣ,805,0,0,-84,0,2021-02-21T00:00:00,1370,1370,603,1973
ΧΑΛΚΙΔΙΚΗΣ,207,0,0,-236,0,2021-02-21T00:00:00,3232,3232,1371,4603
ΧΑΝΙΩΝ,1304,0,0,-425,0,2021-02-21T00:00:00,7698,7698,3902,11600
ΧΙΟΥ,1105,0,0,-144,0,2021-02-21T00:00:00,2210,2210,824,3034
ΑΙΤΩΛΟΑΚΑΡΝΑΝΙΑΣ,701,327,98,425,425,2021-02-22T00:00:00,5875,5875,2155,8030
ΑΝΑΤΟΛΙΚΗΣ ΑΤΤΙΚΗΣ,901,323,519,698,842,2021-02-22T00:00:00,11773,11773,4966,16739
ΑΝΔΡΟΥ,1201,4,39,43,43,2021-02-22T00:00:00,293,293,151,444
ΑΡΓΟΛΙΔΑΣ,1001,170,111,281,281,2021-02-22T00:00:00,3859,3859,1919,5778
ΑΡΚΑΔΙΑΣ,1002,212,59,271,271,2021-02-22T00:00:00,3767,3767,1860,5627
ΑΡΤΑΣ,401,121,104,225,225,2021-02-22T00:00:00,3672,3672,1926,5598
ΑΧΑΪΑΣ,702,221,543,764,764,2021-02-22T00:00:00,11256,11256,6822,18078
ΒΟΙΩΤΙΑΣ,801,336,110,446,446,2021-02-22T00:00:00,4346,4346,1866,6212
ΒΟΡΕΙΟΥ ΤΟΜΕΑ ΑΘΗΝΩΝ,902,4042,990,4584,5032,2021-02-22T00:00:00,65831,65831,31726,97557
ΓΡΕΒΕΝΩΝ,301,83,7,90,90,2021-02-22T00:00:00,1565,1565,678,2243
ΔΡΑΜΑΣ,101,195,88,283,283,2021-02-22T00:00:00,3894,3894,1940,5834
ΔΥΤΙΚΗΣ ΑΤΤΙΚΗΣ,903,119,302,421,421,2021-02-22T00:00:00,3625,3625,2469,6094
ΔΥΤΙΚΟΥ ΤΟΜΕΑ ΑΘΗΝΩΝ,904,372,622,733,994,2021-02-22T00:00:00,19439,19439,9414,28853
ΕΒΡΟΥ,102,346,91,437,437,2021-02-22T00:00:00,6814,6814,3799,10613
ΕΥΒΟΙΑΣ,802,357,336,691,693,2021-02-22T00:00:00,7217,7217,4281,11498
ΕΥΡΥΤΑΝΙΑΣ,803,55,19,74,74,2021-02-22T00:00:00,844,844,467,1311
ΖΑΚΥΝΘΟΥ,601,15,93,108,108,2021-02-22T00:00:00,1385,1385,1076,2461
ΗΛΕΙΑΣ,703,177,139,316,316,2021-02-22T00:00:00,4512,4512,2535,7047
ΗΜΑΘΙΑΣ,201,240,112,352,352,2021-02-22T00:00:00,5660,5660,2418,8078
ΗΡΑΚΛΕΙΟΥ,1301,443,297,740,740,2021-02-22T00:00:00,11585,11585,7302,18887
ΘΑΣΟΥ,103,1,41,42,42,2021-02-22T00:00:00,421,421,190,611
ΘΕΣΠΡΩΤΙΑΣ,402,126,58,184,184,2021-02-22T00:00:00,2573,2573,1323,3896
ΘΕΣΣΑΛΟΝΙΚΗΣ,202,2236,1480,3716,3716,2021-02-22T00:00:00,55765,55765,26547,82312
ΘΗΡΑΣ,1202,7,29,36,36,2021-02-22T00:00:00,386,386,273,659
ΙΘΑΚΗΣ,602,5,1,6,6,2021-02-22T00:00:00,124,124,1,125
ΙΚΑΡΙΑΣ,1101,37,40,77,77,2021-02-22T00:00:00,770,770,308,1078
ΙΩΑΝΝΙΝΩΝ,403,319,223,542,542,2021-02-22T00:00:00,9406,9406,5613,15019
ΚΑΒΑΛΑΣ,104,155,128,283,283,2021-02-22T00:00:00,5056,5056,2645,7701
ΚΑΛΥΜΝΟΥ,1203,5,34,39,39,2021-02-22T00:00:00,726,726,600,1326
ΚΑΡΔΙΤΣΑΣ,501,231,234,465,465,2021-02-22T00:00:00,5753,5753,2627,8380
ΚΑΡΠΑΘΟΥ,1204,0,30,30,30,2021-02-22T00:00:00,271,271,216,487
ΚΑΣΤΟΡΙΑΣ,302,93,60,153,153,2021-02-22T00:00:00,2473,2473,1257,3730
ΚΕΑΣ-ΚΥΘΝΟΥ,1205,0,0,0,0,2021-02-22T00:00:00,44,44,0,44
ΚΕΝΤΡΙΚΟΥ ΤΟΜΕΑ ΑΘΗΝΩΝ,905,1753,1798,1394,3551,2021-02-22T00:00:00,73570,73570,37544,111114
ΚΕΡΚΥΡΑΣ,603,51,122,173,173,2021-02-22T00:00:00,3687,3687,2233,5920
ΚΕΦΑΛΛΗΝΙΑΣ,604,172,102,274,274,2021-02-22T00:00:00,2050,2050,1464,3514
ΚΙΛΚΙΣ,203,185,133,318,318,2021-02-22T00:00:00,3591,3591,1883,5474
ΚΟΖΑΝΗΣ,303,231,111,342,342,2021-02-22T00:00:00,5853,5853,2366,8219
ΚΟΡΙΝΘΙΑΣ,1003,180,153,333,333,2021-02-22T00:00:00,4384,4384,1634,6018
ΚΩ,1206,111,129,163,240,2021-02-22T00:00:00,1454,1454,819,2273
ΛΑΚΩΝΙΑΣ,1004,141,141,282,282,2021-02-22T00:00:00,4088,4088,1917,6005
ΛΑΡΙΣΑΣ,502,536,299,835,835,2021-02-22T00:00:00,10927,10927,4759,15686
ΛΑΣΙΘΙΟΥ,1302,124,214,338,338,2021-02-22T00:00:00,4499,4499,3086,7585
ΛΕΣΒΟΥ,1102,44,164,208,208,2021-02-22T00:00:00,2883,2883,2005,4888
ΛΕΥΚΑΔΑΣ,605,77,27,104,104,2021-02-22T00:00:00,1775,1775,746,2521
ΛΗΜΝΟΥ,1103,1,59,60,60,2021-02-22T00:00:00,791,791,612,1403
ΜΑΓΝΗΣΙΑΣ,503,231,257,488,488,2021-02-22T00:00:00,5821,5821,2818,8639
ΜΕΣΣΗΝΙΑΣ,1005,292,177,469,469,2021-02-22T00:00:00,6420,6420,3061,9481
ΜΗΛΟΥ,1207,2,25,27,27,2021-02-22T00:00:00,292,292,50,342
ΜΥΚΟΝΟΥ,1208,2,40,42,42,2021-02-22T00:00:00,159,159,124,283
ΝΑΞΟΥ,1209,0,48,48,48,2021-02-22T00:00:00,456,456,359,815
ΝΗΣΩΝ,906,34,199,233,233,2021-02-22T00:00:00,1875,1875,917,2792
ΝΟΤΙΟΥ ΤΟΜΕΑ ΑΘΗΝΩΝ,907,474,296,602,770,2021-02-22T00:00:00,11055,11055,4578,15633
ΞΑΝΘΗΣ,105,185,22,207,207,2021-02-22T00:00:00,2933,2933,1653,4586
ΠΑΡΟΥ,1210,0,42,42,42,2021-02-22T00:00:00,303,303,153,456
ΠΕΙΡΑΙΩΣ,908,482,554,572,1036,2021-02-22T00:00:00,18111,18111,9189,27300
ΠΕΛΛΑΣ,204,146,270,416,416,2021-02-22T00:00:00,6399,6399,2753,9152
ΠΙΕΡΙΑΣ,205,62,177,239,239,2021-02-22T00:00:00,4440,4440,2032,6472
ΠΡΕΒΕΖΑΣ,404,156,3,159,159,2021-02-22T00:00:00,2109,2109,845,2954
ΡΕΘΥΜΝΟΥ,1303,153,142,295,295,2021-02-22T00:00:00,3199,3199,1967,5166
ΡΟΔΟΠΗΣ,106,118,59,177,177,2021-02-22T00:00:00,2832,2832,1306,4138
ΡΟΔΟΥ,1211,118,99,129,217,2021-02-22T00:00:00,3399,3399,1920,5319
ΣΑΜΟΥ,1104,37,47,84,84,2021-02-22T00:00:00,1167,1167,720,1887
ΣΕΡΡΩΝ,206,396,66,462,462,2021-02-22T00:00:00,5478,5478,2070,7548
ΣΠΟΡΑΔΩΝ,504,11,55,66,66,2021-02-22T00:00:00,285,285,183,468
ΣΥΡΟΥ,1212,2,58,60,60,2021-02-22T00:00:00,904,904,669,1573
ΤΗΝΟΥ,1213,0,48,48,48,2021-02-22T00:00:00,298,298,175,473
ΤΡΙΚΑΛΩΝ,505,311,133,444,444,2021-02-22T00:00:00,6390,6390,2663,9053
ΦΘΙΩΤΙΔΑΣ,804,191,125,316,316,2021-02-22T00:00:00,4642,4642,2579,7221
ΦΛΩΡΙΝΑΣ,304,98,53,151,151,2021-02-22T00:00:00,2127,2127,1151,3278
ΦΩΚΙΔΑΣ,805,61,38,99,99,2021-02-22T00:00:00,1431,1431,641,2072
ΧΑΛΚΙΔΙΚΗΣ,207,309,100,409,409,2021-02-22T00:00:00,3541,3541,1471,5012
ΧΑΝΙΩΝ,1304,215,324,539,539,2021-02-22T00:00:00,7913,7913,4226,12139
ΧΙΟΥ,1105,99,55,154,154,2021-02-22T00:00:00,2309,2309,879,3188
ΑΙΤΩΛΟΑΚΑΡΝΑΝΙΑΣ,701,270,116,-39,386,2021-02-23T00:00:00,6145,6145,2271,8416
ΑΝΑΤΟΛΙΚΗΣ ΑΤΤΙΚΗΣ,901,325,515,-2,840,2021-02-23T00:00:00,12098,12098,5481,17579
ΑΝΔΡΟΥ,1201,3,38,-2,41,2021-02-23T00:00:00,296,296,189,485
ΑΡΓΟΛΙΔΑΣ,1001,136,149,4,285,2021-02-23T00:00:00,3995,3995,2068,6063
ΑΡΚΑΔΙΑΣ,1002,172,105,6,277,2021-02-23T00:00:00,3939,3939,1965,5904
ΑΡΤΑΣ,401,86,102,-37,188,2021-02-23T00:00:00,3758,3758,2028,5786
ΑΧΑΪΑΣ,702,294,435,-35,729,2021-02-23T00:00:00,11550,11550,7257,18807
ΒΟΙΩΤΙΑΣ,801,309,97,-40,406,2021-02-23T00:00:00,4655,4655,1963,6618
ΒΟΡΕΙΟΥ ΤΟΜΕΑ ΑΘΗΝΩΝ,902,3894,1125,-13,5019,2021-02-23T00:00:00,69725,69725,32851,102576
ΓΡΕΒΕΝΩΝ,301,85,8,3,93,2021-02-23T00:00:00,1650,1650,686,2336
ΔΡΑΜΑΣ,101,174,64,-45,238,2021-02-23T00:00:00,4068,4068,2004,6072
ΔΥΤΙΚΗΣ ΑΤΤΙΚΗΣ,903,116,193,-112,309,2021-02-23T00:00:00,3741,3741,2662,6403
ΔΥΤΙΚΟΥ ΤΟΜΕΑ ΑΘΗΝΩΝ,904,429,705,140,1134,2021-02-23T00:00:00,19868,19868,10119,29987
ΕΒΡΟΥ,102,338,89,-10,427,2021-02-23T00:00:00,7152,7152,3888,11040
ΕΥΒΟΙΑΣ,802,350,207,-136,557,2021-02-23T00:00:00,7567,7567,4488,12055
ΕΥΡΥΤΑΝΙΑΣ,803,52,21,-1,73,2021-02-23T00:00:00,896,896,488,1384
ΖΑΚΥΝΘΟΥ,601,52,50,-6,102,2021-02-23T00:00:00,1437,1437,1126,2563
ΗΛΕΙΑΣ,703,140,178,2,318,2021-02-23T00:00:00,4652,4652,2713,7365
ΗΜΑΘΙΑΣ,201,207,156,11,363,2021-02-23T00:00:00,5867,5867,2574,8441
ΗΡΑΚΛΕΙΟΥ,1301,419,306,-15,725,2021-02-23T00:00:00,12004,12004,7608,19612
ΘΑΣΟΥ,103,2,46,6,48,2021-02-23T00:00:00,423,423,236,659
ΘΕΣΠΡΩΤΙΑΣ,402,83,95,-6,178,2021-02-23T00:00:00,2656,2656,1418,4074
ΘΕΣΣΑΛΟΝΙΚΗΣ,202,1927,1538,-251,3465,2021-02-23T00:00:00,57692,57692,28085,85777
ΘΗΡΑΣ,1202,1,11,-24,12,2021-02-23T00:00:00,387,387,284,671
ΙΘΑΚΗΣ,602,4,2,0,6,2021-02-23T00:00:00,128,128,3,131
ΙΚΑΡΙΑΣ,1101,22,10,-45,32,2021-02-23T00:00:00,792,792,318,1110
ΙΩΑΝΝΙΝΩΝ,403,351,138,-53,489,2021-02-23T00:00:00,9757,9757,5751,15508
ΚΑΒΑΛΑΣ,104,152,116,-15,268,2021-02-23T00:00:00,5208,5208,2761,7969
ΚΑΛΥΜΝΟΥ,1203,1,36,-2,37,2021-02-23T00:00:00,727,727,636,1363
ΚΑΡΔΙΤΣΑΣ,501,217,252,4,469,2021-02-23T00:00:00,5970,5970,2879,8849
ΚΑΡΠΑΘΟΥ,1204,1,10,-19,11,2021-02-23T00:00:00,272,272,226,498
ΚΑΣΤΟΡΙΑΣ,302,98,60,5,158,2021-02-23T00:00:00,2571,2571,1317,3888
ΚΕΑΣ-ΚΥΘΝΟΥ,1205,0,0,0,0,2021-02-23T00:00:00,44,44,0,44
ΚΕΝΤΡΙΚΟΥ ΤΟΜΕΑ ΑΘΗΝΩΝ,905,1879,2179,507,4058,2021-02-23T00:00:00,75449,75449,39723,115172
ΚΕΡΚΥΡΑΣ,603,63,102,-8,165,2021-02-23T00:00:00,3750,3750,2335,6085
ΚΕΦΑΛΛΗΝΙΑΣ,604,71,19,-184,90,2021-02-23T00:00:00,2121,2121,1483,3604
ΚΙΛΚΙΣ,203,173,130,-15,303,2021-02-23T00:00:00,3764,3764,2013,5777
ΚΟΖΑΝΗΣ,303,191,163,12,354,2021-02-23T00:00:00,6044,6044,2529,8573
ΚΟΡΙΝΘΙΑΣ,1003,180,137,-16,317,2021-02-23T00:00:00,4564,4564,1771,6335
ΚΩ,1206,40,66,-134,106,2021-02-23T00:00:00,1494,1494,885,2379
ΛΑΚΩΝΙΑΣ,1004,141,133,-8,274,2021-02-23T00:00:00,4229,4229,2050,6279
ΛΑΡΙΣΑΣ,502,413,320,-102,733,2021-02-23T00:00:00,11340,11340,5079,16419
ΛΑΣΙΘΙΟΥ,1302,120,210,-8,330,2021-02-23T00:00:00,4619,4619,3296,7915
ΛΕΣΒΟΥ,1102,43,84,-81,127,2021-02-23T00:00:00,2926,2926,2089,5015
ΛΕΥΚΑΔΑΣ,605,90,4,-10,94,2021-02-23T00:00:00,1865,1865,750,2615
ΛΗΜΝΟΥ,1103,0,18,-42,18,2021-02-23T00:00:00,791,791,630,1421
ΜΑΓΝΗΣΙΑΣ,503,242,191,-55,433,2021-02-23T00:00:00,6063,6063,3009,9072
ΜΕΣΣΗΝΙΑΣ,1005,194,226,-49,420,2021-02-23T00:00:00,6614,6614,3287,9901
ΜΗΛΟΥ,1207,0,22,-5,22,2021-02-23T00:00:00,292,292,72,364
ΜΥΚΟΝΟΥ,1208,6,18,-18,24,2021-02-23T00:00:00,165,165,142,307
ΝΑΞΟΥ,1209,0,12,-36,12,2021-02-23T00:00:00,456,456,371,827
ΝΗΣΩΝ,906,36,194,-3,230,2021-02-23T00:00:00,1911,1911,1111,3022
ΝΟΤΙΟΥ ΤΟΜΕΑ ΑΘΗΝΩΝ,907,613,289,132,902,2021-02-23T00:00:00,11668,11668,4867,16535
ΞΑΝΘΗΣ,105,140,59,-8,199,2021-02-23T00:00:00,3073,3073,1712,4785
ΠΑΡΟΥ,1210,1,41,0,42,2021-02-23T00:00:00,304,304,194,498
ΠΕΙΡΑΙΩΣ,908,595,599,158,1194,2021-02-23T00:00:00,18706,18706,9788,28494
ΠΕΛΛΑΣ,204,123,278,-15,401,2021-02-23T00:00:00,6522,6522,3031,9553
ΠΙΕΡΙΑΣ,205,66,211,38,277,2021-02-23T00:00:00,4506,4506,2243,6749
ΠΡΕΒΕΖΑΣ,404,157,7,5,164,2021-02-23T00:00:00,2266,2266,852,3118
ΡΕΘΥΜΝΟΥ,1303,174,127,6,301,2021-02-23T00:00:00,3373,3373,2094,5467
ΡΟΔΟΠΗΣ,106,102,63,-12,165,2021-02-23T00:00:00,2934,2934,1369,4303
ΡΟΔΟΥ,1211,155,13,-49,168,2021-02-23T00:00:00,3554,3554,1933,5487
ΣΑΜΟΥ,1104,37,12,-35,49,2021-02-23T00:00:00,1204,1204,732,1936
ΣΕΡΡΩΝ,206,378,70,-14,448,2021-02-23T00:00:00,5856,5856,2140,7996
ΣΠΟΡΑΔΩΝ,504,0,12,-54,12,2021-02-23T00:00:00,285,285,195,480
ΣΥΡΟΥ,1212,2,4,-54,6,2021-02-23T00:00:00,906,906,673,1579
ΤΗΝΟΥ,1213,6,36,-6,42,2021-02-23T00:00:00,304,304,211,515
ΤΡΙΚΑΛΩΝ,505,229,192,-23,421,2021-02-23T00:00:00,6619,6619,2855,9474
ΦΘΙΩΤΙΔΑΣ,804,205,83,-28,288,2021-02-23T00:00:00,4847,4847,2662,7509
ΦΛΩΡΙΝΑΣ,304,91,52,-8,143,2021-02-23T00:00:00,2218,2218,1203,3421
ΦΩΚΙΔΑΣ,805,45,52,-2,97,2021-02-23T00:00:00,1476,1476,693,2169
ΧΑΛΚΙΔΙΚΗΣ,207,259,100,-50,359,2021-02-23T00:00:00,3800,3800,1571,5371
ΧΑΝΙΩΝ,1304,243,371,75,614,2021-02-23T00:00:00,8156,8156,4597,12753
ΧΙΟΥ,1105,115,14,-25,129,2021-02-23T00:00:00,2424,2424,893,3317
ΑΙΤΩΛΟΑΚΑΡΝΑΝΙΑΣ,701,232,172,18,404,2021-02-24T00:00:00,6377,6377,2443,8820
ΑΝΑΤΟΛΙΚΗΣ ΑΤΤΙΚΗΣ,901,398,502,60,900,2021-02-24T00:00:00,12496,12496,5983,18479
ΑΝΔΡΟΥ,1201,1,42,2,43,2021-02-24T00:00:00,297,297,231,528
ΑΡΓΟΛΙΔΑΣ,1001,110,159,-16,269,2021-02-24T00:00:00,4105,4105,2227,6332
ΑΡΚΑΔΙΑΣ,1002,127,156,6,283,2021-02-24T00:00:00,4066,4066,2121,6187
ΑΡΤΑΣ,401,40,153,5,193,2021-02-24T00:00:00,3798,3798,2181,5979
ΑΧΑΪΑΣ,702,283,392,-54,675,2021-02-24T00:00:00,11833,11833,7649,19482
ΒΟΙΩΤΙΑΣ,801,262,121,-23,383,2021-02-24T00:00:00,4917,4917,2084,7001
ΒΟΡΕΙΟΥ ΤΟΜΕΑ ΑΘΗΝΩΝ,902,3933,1353,267,5286,2021-02-24T00:00:00,73658,73658,34204,107862
ΓΡΕΒΕΝΩΝ,301,37,43,-13,80,2021-02-24T00:00:00,1687,1687,729,2416
ΔΡΑΜΑΣ,101,100,145,7,245,2021-02-24T00:00:00,4168,4168,2149,6317
ΔΥΤΙΚΗΣ ΑΤΤΙΚΗΣ,903,146,66,-97,212,2021-02-24T00:00:00,3887,3887,2728,6615
ΔΥΤΙΚΟΥ ΤΟΜΕΑ ΑΘΗΝΩΝ,904,392,631,-111,1023,2021-02-24T00:00:00,20260,20260,10750,31010
ΕΒΡΟΥ,102,279,154,6,433,2021-02-24T00:00:00,7431,7431,4042,11473
ΕΥΒΟΙΑΣ,802,230,296,-31,526,2021-02-24T00:00:00,7797,7797,4784,12581
ΕΥΡΥΤΑΝΙΑΣ,803,30,40,-3,70,2021-02-24T00:00:00,926,926,528,1454
ΖΑΚΥΝΘΟΥ,601,48,11,-43,59,2021-02-24T00:00:00,1485,1485,1137,2622
ΗΛΕΙΑΣ,703,124,218,24,342,2021-02-24T00:00:00,4776,4776,2931,7707
ΗΜΑΘΙΑΣ,201,166,199,2,365,2021-02-24T00:00:00,6033,6033,2773,8806
ΗΡΑΚΛΕΙΟΥ,1301,453,273,1,726,2021-02-24T00:00:00,12457,12457,7881,20338
ΘΑΣΟΥ,103,6,36,-6,42,2021-02-24T00:00:00,429,429,272,701
ΘΕΣΠΡΩΤΙΑΣ,402,42,104,-32,146,2021-02-24T00:00:00,2698,2698,1522,4220
ΘΕΣΣΑΛΟΝΙΚΗΣ,202,2057,1590,182,3647,2021-02-24T00:00:00,59749,59749,29675,89424
ΘΗΡΑΣ,1202,5,13,6,18,2021-02-24T00:00:00,392,392,297,689
ΙΘΑΚΗΣ,602,0,0,-6,0,2021-02-24T00:00:00,128,128,3,131
ΙΚΑΡΙΑΣ,1101,15,20,3,35,2021-02-24T00:00:00,807,807,338,1145
ΙΩΑΝΝΙΝΩΝ,403,236,242,-11,478,2021-02-24T00:00:00,9993,9993,5993,15986
ΚΑΒΑΛΑΣ,104,170,114,16,284,2021-02-24T00:00:00,5378,5378,2875,8253
ΚΑΛΥΜΝΟΥ,1203,5,13,-19,18,2021-02-24T00:00:00,732,732,649,1381
ΚΑΡΔΙΤΣΑΣ,501,251,226,8,477,2021-02-24T00:00:00,6221,6221,3105,9326
ΚΑΡΠΑΘΟΥ,1204,0,13,2,13,2021-02-24T00:00:00,272,272,239,511
ΚΑΣΤΟΡΙΑΣ,302,89,52,-17,141,2021-02-24T00:00:00,2660,2660,1369,4029
ΚΕΑΣ-ΚΥΘΝΟΥ,1205,0,0,0,0,2021-02-24T00:00:00,44,44,0,44
ΚΕΝΤΡΙΚΟΥ ΤΟΜΕΑ ΑΘΗΝΩΝ,905,1614,2332,-112,3946,2021-02-24T00:00:00,77063,77063,42055,119118
ΚΕΡΚΥΡΑΣ,603,50,109,-6,159,2021-02-24T00:00:00,3800,3800,2444,6244
ΚΕΦΑΛΛΗΝΙΑΣ,604,7,10,-73,17,2021-02-24T00:00:00,2128,2128,1493,3621
ΚΙΛΚΙΣ,203,174,92,-37,266,2021-02-24T00:00:00,3938,3938,2105,6043
ΚΟΖΑΝΗΣ,303,145,193,-16,338,2021-02-24T00:00:00,6189,6189,2722,8911
ΚΟΡΙΝΘΙΑΣ,1003,178,148,9,326,2021-02-24T00:00:00,4742,4742,1919,6661
ΚΩ,1206,40,6,-60,46,2021-02-24T00:00:00,1534,1534,891,2425
ΛΑΚΩΝΙΑΣ,1004,130,154,10,284,2021-02-24T00:00:00,4359,4359,2204,6563
ΛΑΡΙΣΑΣ,502,334,350,-49,684,2021-02-24T00:00:00,11674,11674,5429,17103
ΛΑΣΙΘΙΟΥ,1302,104,139,-87,243,2021-02-24T00:00:00,4723,4723,3435,8158
ΛΕΣΒΟΥ,1102,44,72,-11,116,2021-02-24T00:00:00,2970,2970,2161,5131
ΛΕΥΚΑΔΑΣ,605,58,38,2,96,2021-02-24T00:00:00,1923,1923,788,2711
ΛΗΜΝΟΥ,1103,3,9,-6,12,2021-02-24T00:00:00,794,794,639,1433
ΜΑΓΝΗΣΙΑΣ,503,230,163,-40,393,2021-02-24T00:00:00,6293,6293,3172,9465
ΜΕΣΣΗΝΙΑΣ,1005,181,254,15,435,2021-02-24T00:00:00,6795,6795,3541,10336
ΜΗΛΟΥ,1207,4,18,0,22,2021-02-24T00:00:00,296,296,90,386
ΜΥΚΟΝΟΥ,1208,0,0,-24,0,2021-02-24T00:00:00,165,165,142,307
ΝΑΞΟΥ,1209,2,22,12,24,2021-02-24T00:00:00,458,458,393,851
ΝΗΣΩΝ,906,22,116,-92,138,2021-02-24T00:00:00,1933,1933,1227,3160
ΝΟΤΙΟΥ ΤΟΜΕΑ ΑΘΗΝΩΝ,907,560,299,-43,859,2021-02-24T00:00:00,12228,12228,5166,17394
ΞΑΝΘΗΣ,105,138,68,7,206,2021-02-24T00:00:00,3211,3211,1780,4991
ΠΑΡΟΥ,1210,0,36,-6,36,2021-02-24T00:00:00,304,304,230,534
ΠΕΙΡΑΙΩΣ,908,760,613,179,1373,2021-02-24T00:00:00,19466,19466,10401,29867
ΠΕΛΛΑΣ,204,127,292,18,419,2021-02-24T00:00:00,6649,6649,3323,9972
ΠΙΕΡΙΑΣ,205,32,207,-38,239,2021-02-24T00:00:00,4538,4538,2450,6988
ΠΡΕΒΕΖΑΣ,404,117,45,-2,162,2021-02-24T00:00:00,2383,2383,897,3280
ΡΕΘΥΜΝΟΥ,1303,200,69,-32,269,2021-02-24T00:00:00,3573,3573,2163,5736
ΡΟΔΟΠΗΣ,106,100,47,-18,147,2021-02-24T00:00:00,3034,3034,1416,4450
ΡΟΔΟΥ,1211,180,11,23,191,2021-02-24T00:00:00,3734,3734,1944,5678
ΣΑΜΟΥ,1104,40,6,-3,46,2021-02-24T00:00:00,1244,1244,738,1982
ΣΕΡΡΩΝ,206,371,55,-22,426,2021-02-24T00:00:00,6227,6227,2195,8422
ΣΠΟΡΑΔΩΝ,504,1,5,-6,6,2021-02-24T00:00:00,286,286,200,486
ΣΥΡΟΥ,1212,3,3,0,6,2021-02-24T00:00:00,909,909,676,1585
ΤΗΝΟΥ,1213,2,28,-12,30,2021-02-24T00:00:00,306,306,239,545
ΤΡΙΚΑΛΩΝ,505,200,198,-23,398,2021-02-24T00:00:00,6819,6819,3053,9872
ΦΘΙΩΤΙΔΑΣ,804,232,33,-23,265,2021-02-24T00:00:00,5079,5079,2695,7774
ΦΛΩΡΙΝΑΣ,304,61,86,4,147,2021-02-24T00:00:00,2279,2279,1289,3568
ΦΩΚΙΔΑΣ,805,71,52,26,123,2021-02-24T00:00:00,1547,1547,745,2292
ΧΑΛΚΙΔΙΚΗΣ,207,253,60,-46,313,2021-02-24T00:00:00,4053,4053,1631,5684
ΧΑΝΙΩΝ,1304,204,365,-45,569,2021-02-24T00:00:00,8360,8360,4962,13322
ΧΙΟΥ,1105,123,9,3,132,2021-02-24T00:00:00,2547,2547,902,3449
ΑΙΤΩΛΟΑΚΑΡΝΑΝΙΑΣ,701,96,0,18,96,2021-01-21T00:00:00,1117,1117,0,1117
ΑΝΑΤΟΛΙΚΗΣ ΑΤΤΙΚΗΣ,901,314,44,42,358,2021-01-21T00:00:00,1404,1404,226,1630
ΑΝΔΡΟΥ,1201,0,0,0,0,2021-01-21T00:00:00,0,0,0,0
ΑΡΓΟΛΙΔΑΣ,1001,198,0,24,198,2021-01-21T00:00:00,879,879,0,879
ΑΡΚΑΔΙΑΣ,1002,145,0,37,145,2021-01-21T00:00:00,866,866,0,866
ΑΡΤΑΣ,401,138,0,6,138,2021-01-21T00:00:00,916,916,0,916
ΑΧΑΪΑΣ,702,424,113,3,537,2021-01-21T00:00:00,3415,3415,301,3716
ΒΟΙΩΤΙΑΣ,801,145,0,-10,145,2021-01-21T00:00:00,770,770,0,770
ΒΟΡΕΙΟΥ ΤΟΜΕΑ ΑΘΗΝΩΝ,902,2208,0,17,2208,2021-01-21T00:00:00,18717,18717,0,18717
ΓΡΕΒΕΝΩΝ,301,56,0,20,56,2021-01-21T00:00:00,371,371,0,371
ΔΡΑΜΑΣ,101,180,0,12,180,2021-01-21T00:00:00,871,871,0,871
ΔΥΤΙΚΗΣ ΑΤΤΙΚΗΣ,903,169,35,29,204,2021-01-21T00:00:00,890,890,230,1120
ΔΥΤΙΚΟΥ ΤΟΜΕΑ ΑΘΗΝΩΝ,904,519,21,56,540,2021-01-21T00:00:00,4038,4038,215,4253
ΕΒΡΟΥ,102,319,0,18,319,2021-01-21T00:00:00,2076,2076,0,2076
ΕΥΒΟΙΑΣ,802,357,0,-77,357,2021-01-21T00:00:00,1717,1717,0,1717
ΕΥΡΥΤΑΝΙΑΣ,803,31,0,2,31,2021-01-21T00:00:00,271,271,0,271
ΖΑΚΥΝΘΟΥ,601,101,0,-1,101,2021-01-21T00:00:00,453,453,0,453
ΗΛΕΙΑΣ,703,198,0,0,198,2021-01-21T00:00:00,1166,1166,0,1166
ΗΜΑΘΙΑΣ,201,199,0,64,199,2021-01-21T00:00:00,1102,1102,0,1102
ΗΡΑΚΛΕΙΟΥ,1301,484,0,-4,484,2021-01-21T00:00:00,4355,4355,0,4355
ΘΑΣΟΥ,103,0,0,0,0,2021-01-21T00:00:00,0,0,0,0
ΘΕΣΠΡΩΤΙΑΣ,402,96,0,0,96,2021-01-21T00:00:00,577,577,0,577
ΘΕΣΣΑΛΟΝΙΚΗΣ,202,1504,78,35,1582,2021-01-21T00:00:00,15075,15075,216,15291
ΘΗΡΑΣ,1202,24,0,6,24,2021-01-21T00:00:00,107,107,0,107
ΙΘΑΚΗΣ,602,0,0,0,0,2021-01-21T00:00:00,0,0,0,0
ΙΚΑΡΙΑΣ,1101,25,0,8,25,2021-01-21T00:00:00,106,106,0,106
ΙΩΑΝΝΙΝΩΝ,403,248,95,14,343,2021-01-21T00:00:00,3357,3357,264,3621
ΚΑΒΑΛΑΣ,104,235,0,87,235,2021-01-21T00:00:00,1142,1142,0,1142
ΚΑΛΥΜΝΟΥ,1203,59,0,26,59,2021-01-21T00:00:00,243,243,0,243
ΚΑΡΔΙΤΣΑΣ,501,209,0,-25,209,2021-01-21T00:00:00,1152,1152,0,1152
ΚΑΡΠΑΘΟΥ,1204,18,0,6,18,2021-01-21T00:00:00,45,45,0,45
ΚΑΣΤΟΡΙΑΣ,302,90,0,31,90,2021-01-21T00:00:00,504,504,0,504
ΚΕΑΣ-ΚΥΘΝΟΥ,1205,0,0,0,0,2021-01-21T00:00:00,0,0,0,0
ΚΕΝΤΡΙΚΟΥ ΤΟΜΕΑ ΑΘΗΝΩΝ,905,1560,117,-60,1677,2021-01-21T00:00:00,23814,23814,525,24339
ΚΕΡΚΥΡΑΣ,603,243,0,12,243,2021-01-21T00:00:00,902,902,0,902
ΚΕΦΑΛΛΗΝΙΑΣ,604,113,0,-24,113,2021-01-21T00:00:00,620,620,0,620
ΚΙΛΚΙΣ,203,180,0,-22,180,2021-01-21T00:00:00,828,828,0,828
ΚΟΖΑΝΗΣ,303,144,0,30,144,2021-01-21T00:00:00,1163,1163,0,1163
ΚΟΡΙΝΘΙΑΣ,1003,109,0,38,109,2021-01-21T00:00:00,560,560,0,560
ΚΩ,1206,48,0,-18,48,2021-01-21T00:00:00,307,307,0,307
ΛΑΚΩΝΙΑΣ,1004,180,0,24,180,2021-01-21T00:00:00,975,975,0,975
ΛΑΡΙΣΑΣ,502,230,94,18,324,2021-01-21T00:00:00,2545,2545,284,2829
ΛΑΣΙΘΙΟΥ,1302,238,0,-15,238,2021-01-21T00:00:00,1284,1284,0,1284
ΛΕΣΒΟΥ,1102,179,0,28,179,2021-01-21T00:00:00,782,782,0,782
ΛΕΥΚΑΔΑΣ,605,67,0,20,67,2021-01-21T00:00:00,285,285,0,285
ΛΗΜΝΟΥ,1103,0,0,-42,0,2021-01-21T00:00:00,269,269,0,269
ΜΑΓΝΗΣΙΑΣ,503,126,0,48,126,2021-01-21T00:00:00,886,886,0,886
ΜΕΣΣΗΝΙΑΣ,1005,237,0,62,237,2021-01-21T00:00:00,1182,1182,0,1182
ΜΗΛΟΥ,1207,0,0,0,0,2021-01-21T00:00:00,0,0,0,0
ΜΥΚΟΝΟΥ,1208,0,0,0,0,2021-01-21T00:00:00,0,0,0,0
ΝΑΞΟΥ,1209,30,0,0,30,2021-01-21T00:00:00,132,132,0,132
ΝΗΣΩΝ,906,6,0,-12,6,2021-01-21T00:00:00,88,88,0,88
ΝΟΤΙΟΥ ΤΟΜΕΑ ΑΘΗΝΩΝ,907,257,0,-15,257,2021-01-21T00:00:00,1971,1971,0,1971
ΞΑΝΘΗΣ,105,121,0,4,121,2021-01-21T00:00:00,908,908,0,908
ΠΑΡΟΥ,1210,0,0,0,0,2021-01-21T00:00:00,0,0,0,0
ΠΕΙΡΑΙΩΣ,908,504,0,-132,504,2021-01-21T00:00:00,4332,4332,0,4332
ΠΕΛΛΑΣ,204,246,0,50,246,2021-01-21T00:00:00,1126,1126,0,1126
ΠΙΕΡΙΑΣ,205,102,0,-6,102,2021-01-21T00:00:00,732,732,0,732
ΠΡΕΒΕΖΑΣ,404,66,0,18,66,2021-01-21T00:00:00,525,525,0,525
ΡΕΘΥΜΝΟΥ,1303,142,0,-8,142,2021-01-21T00:00:00,817,817,0,817
ΡΟΔΟΠΗΣ,106,102,0,12,102,2021-01-21T00:00:00,585,585,0,585
ΡΟΔΟΥ,1211,96,0,0,96,2021-01-21T00:00:00,717,717,0,717
ΣΑΜΟΥ,1104,60,0,12,60,2021-01-21T00:00:00,348,348,0,348
ΣΕΡΡΩΝ,206,139,0,13,139,2021-01-21T00:00:00,1027,1027,0,1027
ΣΠΟΡΑΔΩΝ,504,0,0,0,0,2021-01-21T00:00:00,0,0,0,0
ΣΥΡΟΥ,1212,48,0,0,48,2021-01-21T00:00:00,295,295,0,295
ΤΗΝΟΥ,1213,0,0,0,0,2021-01-21T00:00:00,0,0,0,0
ΤΡΙΚΑΛΩΝ,505,240,0,61,240,2021-01-21T00:00:00,1246,1246,0,1246
ΦΘΙΩΤΙΔΑΣ,804,210,0,71,210,2021-01-21T00:00:00,1183,1183,0,1183
ΦΛΩΡΙΝΑΣ,304,108,0,42,108,2021-01-21T00:00:00,488,488,0,488
ΦΩΚΙΔΑΣ,805,54,0,6,54,2021-01-21T00:00:00,276,276,0,276
ΧΑΛΚΙΔΙΚΗΣ,207,121,0,31,121,2021-01-21T00:00:00,521,521,0,521
ΧΑΝΙΩΝ,1304,351,0,6,351,2021-01-21T00:00:00,1833,1833,0,1833
ΧΙΟΥ,1105,54,0,24,54,2021-01-21T00:00:00,413,413,0,413
ΑΙΤΩΛΟΑΚΑΡΝΑΝΙΑΣ,701,125,0,29,125,2021-01-22T00:00:00,1242,1242,0,1242
ΑΝΑΤΟΛΙΚΗΣ ΑΤΤΙΚΗΣ,901,405,45,92,450,2021-01-22T00:00:00,1809,1809,271,2080
ΑΝΔΡΟΥ,1201,0,0,0,0,2021-01-22T00:00:00,0,0,0,0
ΑΡΓΟΛΙΔΑΣ,1001,146,0,-52,146,2021-01-22T00:00:00,1025,1025,0,1025
ΑΡΚΑΔΙΑΣ,1002,144,0,-1,144,2021-01-22T00:00:00,1010,1010,0,1010
ΑΡΤΑΣ,401,168,0,30,168,2021-01-22T00:00:00,1084,1084,0,1084
ΑΧΑΪΑΣ,702,504,7,-26,511,2021-01-22T00:00:00,3919,3919,308,4227
ΒΟΙΩΤΙΑΣ,801,149,0,4,149,2021-01-22T00:00:00,919,919,0,919
ΒΟΡΕΙΟΥ ΤΟΜΕΑ ΑΘΗΝΩΝ,902,2501,0,293,2501,2021-01-22T00:00:00,21218,21218,0,21218
ΓΡΕΒΕΝΩΝ,301,54,0,-2,54,2021-01-22T00:00:00,425,425,0,425
ΔΡΑΜΑΣ,101,168,0,-12,168,2021-01-22T00:00:00,1039,1039,0,1039
ΔΥΤΙΚΗΣ ΑΤΤΙΚΗΣ,903,269,1,66,270,2021-01-22T00:00:00,1159,1159,231,1390
ΔΥΤΙΚΟΥ ΤΟΜΕΑ ΑΘΗΝΩΝ,904,703,30,193,733,2021-01-22T00:00:00,4741,4741,245,4986
ΕΒΡΟΥ,102,289,0,-30,289,2021-01-22T00:00:00,2365,2365,0,2365
ΕΥΒΟΙΑΣ,802,278,0,-79,278,2021-01-22T00:00:00,1995,1995,0,1995
ΕΥΡΥΤΑΝΙΑΣ,803,36,0,5,36,2021-01-22T00:00:00,307,307,0,307
ΖΑΚΥΝΘΟΥ,601,78,0,-23,78,2021-01-22T00:00:00,531,531,0,531
ΗΛΕΙΑΣ,703,183,0,-15,183,2021-01-22T00:00:00,1349,1349,0,1349
ΗΜΑΘΙΑΣ,201,220,0,21,220,2021-01-22T00:00:00,1322,1322,0,1322
ΗΡΑΚΛΕΙΟΥ,1301,480,0,-4,480,2021-01-22T00:00:00,4835,4835,0,4835
ΘΑΣΟΥ,103,0,0,0,0,2021-01-22T00:00:00,0,0,0,0
ΘΕΣΠΡΩΤΙΑΣ,402,134,0,38,134,2021-01-22T00:00:00,711,711,0,711
ΘΕΣΣΑΛΟΝΙΚΗΣ,202,1941,40,399,1981,2021-01-22T00:00:00,17016,17016,256,17272
ΘΗΡΑΣ,1202,18,0,-6,18,2021-01-22T00:00:00,125,125,0,125
ΙΘΑΚΗΣ,602,0,0,0,0,2021-01-22T00:00:00,0,0,0,0
ΙΚΑΡΙΑΣ,1101,23,0,-2,23,2021-01-22T00:00:00,129,129,0,129
ΙΩΑΝΝΙΝΩΝ,403,392,10,59,402,2021-01-22T00:00:00,3749,3749,274,4023
ΚΑΒΑΛΑΣ,104,240,0,5,240,2021-01-22T00:00:00,1382,1382,0,1382
ΚΑΛΥΜΝΟΥ,1203,49,0,-10,49,2021-01-22T00:00:00,292,292,0,292
ΚΑΡΔΙΤΣΑΣ,501,275,0,66,275,2021-01-22T00:00:00,1427,1427,0,1427
ΚΑΡΠΑΘΟΥ,1204,30,0,12,30,2021-01-22T00:00:00,75,75,0,75
ΚΑΣΤΟΡΙΑΣ,302,113,0,23,113,2021-01-22T00:00:00,617,617,0,617
ΚΕΑΣ-ΚΥΘΝΟΥ,1205,0,0,0,0,2021-01-22T00:00:00,0,0,0,0
ΚΕΝΤΡΙΚΟΥ ΤΟΜΕΑ ΑΘΗΝΩΝ,905,1834,92,249,1926,2021-01-22T00:00:00,25648,25648,617,26265
ΚΕΡΚΥΡΑΣ,603,235,0,-8,235,2021-01-22T00:00:00,1137,1137,0,1137
ΚΕΦΑΛΛΗΝΙΑΣ,604,96,0,-17,96,2021-01-22T00:00:00,716,716,0,716
ΚΙΛΚΙΣ,203,174,0,-6,174,2021-01-22T00:00:00,1002,1002,0,1002
ΚΟΖΑΝΗΣ,303,193,0,49,193,2021-01-22T00:00:00,1356,1356,0,1356
ΚΟΡΙΝΘΙΑΣ,1003,138,0,29,138,2021-01-22T00:00:00,698,698,0,698
ΚΩ,1206,48,0,0,48,2021-01-22T00:00:00,355,355,0,355
ΛΑΚΩΝΙΑΣ,1004,143,0,-37,143,2021-01-22T00:00:00,1118,1118,0,1118
ΛΑΡΙΣΑΣ,502,312,93,81,405,2021-01-22T00:00:00,2857,2857,377,3234
ΛΑΣΙΘΙΟΥ,1302,224,0,-14,224,2021-01-22T00:00:00,1508,1508,0,1508
ΛΕΣΒΟΥ,1102,149,0,-30,149,2021-01-22T00:00:00,931,931,0,931
ΛΕΥΚΑΔΑΣ,605,66,0,-1,66,2021-01-22T00:00:00,351,351,0,351
ΛΗΜΝΟΥ,1103,54,0,54,54,2021-01-22T00:00:00,323,323,0,323
ΜΑΓΝΗΣΙΑΣ,503,148,0,22,148,2021-01-22T00:00:00,1034,1034,0,1034
ΜΕΣΣΗΝΙΑΣ,1005,220,0,-17,220,2021-01-22T00:00:00,1402,1402,0,1402
ΜΗΛΟΥ,1207,0,0,0,0,2021-01-22T00:00:00,0,0,0,0
ΜΥΚΟΝΟΥ,1208,0,0,0,0,2021-01-22T00:00:00,0,0,0,0
ΝΑΞΟΥ,1209,30,0,0,30,2021-01-22T00:00:00,162,162,0,162
ΝΗΣΩΝ,906,18,0,12,18,2021-01-22T00:00:00,106,106,0,106
ΝΟΤΙΟΥ ΤΟΜΕΑ ΑΘΗΝΩΝ,907,359,0,102,359,2021-01-22T00:00:00,2330,2330,0,2330
ΞΑΝΘΗΣ,105,120,0,-1,120,2021-01-22T00:00:00,1028,1028,0,1028
ΠΑΡΟΥ,1210,0,0,0,0,2021-01-22T00:00:00,0,0,0,0
ΠΕΙΡΑΙΩΣ,908,711,0,207,711,2021-01-22T00:00:00,5043,5043,0,5043
ΠΕΛΛΑΣ,204,205,0,-41,205,2021-01-22T00:00:00,1331,1331,0,1331
ΠΙΕΡΙΑΣ,205,168,0,66,168,2021-01-22T00:00:00,900,900,0,900
ΠΡΕΒΕΖΑΣ,404,66,0,0,66,2021-01-22T00:00:00,591,591,0,591
ΡΕΘΥΜΝΟΥ,1303,123,0,-19,123,2021-01-22T00:00:00,940,940,0,940
ΡΟΔΟΠΗΣ,106,96,0,-6,96,2021-01-22T00:00:00,681,681,0,681
ΡΟΔΟΥ,1211,96,0,0,96,2021-01-22T00:00:00,813,813,0,813
ΣΑΜΟΥ,1104,54,0,-6,54,2021-01-22T00:00:00,402,402,0,402
ΣΕΡΡΩΝ,206,150,0,11,150,2021-01-22T00:00:00,1177,1177,0,1177
ΣΠΟΡΑΔΩΝ,504,0,0,0,0,2021-01-22T00:00:00,0,0,0,0
ΣΥΡΟΥ,1212,57,0,9,57,2021-01-22T00:00:00,352,352,0,352
ΤΗΝΟΥ,1213,0,0,0,0,2021-01-22T00:00:00,0,0,0,0
ΤΡΙΚΑΛΩΝ,505,270,0,30,270,2021-01-22T00:00:00,1516,1516,0,1516
ΦΘΙΩΤΙΔΑΣ,804,233,0,23,233,2021-01-22T00:00:00,1416,1416,0,1416
ΦΛΩΡΙΝΑΣ,304,102,0,-6,102,2021-01-22T00:00:00,590,590,0,590
ΦΩΚΙΔΑΣ,805,60,0,6,60,2021-01-22T00:00:00,336,336,0,336
ΧΑΛΚΙΔΙΚΗΣ,207,135,0,14,135,2021-01-22T00:00:00,656,656,0,656
ΧΑΝΙΩΝ,1304,351,0,0,351,2021-01-22T00:00:00,2184,2184,0,2184
ΧΙΟΥ,1105,78,0,24,78,2021-01-22T00:00:00,491,491,0,491
ΑΙΤΩΛΟΑΚΑΡΝΑΝΙΑΣ,701,144,0,19,144,2021-01-23T00:00:00,1386,1386,0,1386
ΑΝΑΤΟΛΙΚΗΣ ΑΤΤΙΚΗΣ,901,411,49,10,460,2021-01-23T00:00:00,2220,2220,320,2540
ΑΝΔΡΟΥ,1201,0,0,0,0,2021-01-23T00:00:00,0,0,0,0
ΑΡΓΟΛΙΔΑΣ,1001,127,0,-19,127,2021-01-23T00:00:00,1152,1152,0,1152
ΑΡΚΑΔΙΑΣ,1002,174,0,30,174,2021-01-23T00:00:00,1184,1184,0,1184
ΑΡΤΑΣ,401,186,0,18,186,2021-01-23T00:00:00,1270,1270,0,1270
ΑΧΑΪΑΣ,702,448,91,28,539,2021-01-23T00:00:00,4367,4367,399,4766
ΒΟΙΩΤΙΑΣ,801,132,0,-17,132,2021-01-23T00:00:00,1051,1051,0,1051
ΒΟΡΕΙΟΥ ΤΟΜΕΑ ΑΘΗΝΩΝ,902,1593,0,-908,1593,2021-01-23T00:00:00,22811,22811,0,22811
ΓΡΕΒΕΝΩΝ,301,42,0,-12,42,2021-01-23T00:00:00,467,467,0,467
ΔΡΑΜΑΣ,101,144,0,-24,144,2021-01-23T00:00:00,1183,1183,0,1183
ΔΥΤΙΚΗΣ ΑΤΤΙΚΗΣ,903,210,0,-60,210,2021-01-23T00:00:00,1369,1369,231,1600
ΔΥΤΙΚΟΥ ΤΟΜΕΑ ΑΘΗΝΩΝ,904,794,57,118,851,2021-01-23T00:00:00,5535,5535,302,5837
ΕΒΡΟΥ,102,240,0,-49,240,2021-01-23T00:00:00,2605,2605,0,2605
ΕΥΒΟΙΑΣ,802,238,0,-40,238,2021-01-23T00:00:00,2233,2233,0,2233
ΕΥΡΥΤΑΝΙΑΣ,803,18,0,-18,18,2021-01-23T00:00:00,325,325,0,325
ΖΑΚΥΝΘΟΥ,601,90,0,12,90,2021-01-23T00:00:00,621,621,0,621
ΗΛΕΙΑΣ,703,157,0,-26,157,2021-01-23T00:00:00,1506,1506,0,1506
ΗΜΑΘΙΑΣ,201,186,0,-34,186,2021-01-23T00:00:00,1508,1508,0,1508
ΗΡΑΚΛΕΙΟΥ,1301,454,0,-26,454,2021-01-23T00:00:00,5289,5289,0,5289
ΘΑΣΟΥ,103,0,0,0,0,2021-01-23T00:00:00,0,0,0,0
ΘΕΣΠΡΩΤΙΑΣ,402,147,0,13,147,2021-01-23T00:00:00,858,858,0,858
ΘΕΣΣΑΛΟΝΙΚΗΣ,202,1712,78,-191,1790,2021-01-23T00:00:00,18728,18728,334,19062
ΘΗΡΑΣ,1202,6,0,-12,6,2021-01-23T00:00:00,131,131,0,131
ΙΘΑΚΗΣ,602,0,0,0,0,2021-01-23T00:00:00,0,0,0,0
ΙΚΑΡΙΑΣ,1101,18,0,-5,18,2021-01-23T00:00:00,147,147,0,147
ΙΩΑΝΝΙΝΩΝ,403,353,68,19,421,2021-01-23T00:00:00,4102,4102,342,4444
ΚΑΒΑΛΑΣ,104,192,0,-48,192,2021-01-23T00:00:00,1574,1574,0,1574
ΚΑΛΥΜΝΟΥ,1203,35,0,-14,35,2021-01-23T00:00:00,327,327,0,327
ΚΑΡΔΙΤΣΑΣ,501,199,0,-76,199,2021-01-23T00:00:00,1626,1626,0,1626
ΚΑΡΠΑΘΟΥ,1204,18,0,-12,18,2021-01-23T00:00:00,93,93,0,93
ΚΑΣΤΟΡΙΑΣ,302,91,0,-22,91,2021-01-23T00:00:00,708,708,0,708
ΚΕΑΣ-ΚΥΘΝΟΥ,1205,0,0,0,0,2021-01-23T00:00:00,0,0,0,0
ΚΕΝΤΡΙΚΟΥ ΤΟΜΕΑ ΑΘΗΝΩΝ,905,1695,129,-102,1824,2021-01-23T00:00:00,27343,27343,746,28089
ΚΕΡΚΥΡΑΣ,603,256,0,21,256,2021-01-23T00:00:00,1393,1393,0,1393
ΚΕΦΑΛΛΗΝΙΑΣ,604,57,0,-39,57,2021-01-23T00:00:00,773,773,0,773
ΚΙΛΚΙΣ,203,102,0,-72,102,2021-01-23T00:00:00,1104,1104,0,1104
ΚΟΖΑΝΗΣ,303,192,0,-1,192,2021-01-23T00:00:00,1548,1548,0,1548
ΚΟΡΙΝΘΙΑΣ,1003,132,0,-6,132,2021-01-23T00:00:00,830,830,0,830
ΚΩ,1206,30,0,-18,30,2021-01-23T00:00:00,385,385,0,385
ΛΑΚΩΝΙΑΣ,1004,143,0,0,143,2021-01-23T00:00:00,1261,1261,0,1261
ΛΑΡΙΣΑΣ,502,407,83,85,490,2021-01-23T00:00:00,3264,3264,460,3724
ΛΑΣΙΘΙΟΥ,1302,198,0,-26,198,2021-01-23T00:00:00,1706,1706,0,1706
ΛΕΣΒΟΥ,1102,144,0,-5,144,2021-01-23T00:00:00,1075,1075,0,1075
ΛΕΥΚΑΔΑΣ,605,72,0,6,72,2021-01-23T00:00:00,423,423,0,423
ΛΗΜΝΟΥ,1103,42,0,-12,42,2021-01-23T00:00:00,365,365,0,365
ΜΑΓΝΗΣΙΑΣ,503,174,0,26,174,2021-01-23T00:00:00,1208,1208,0,1208
ΜΕΣΣΗΝΙΑΣ,1005,231,0,11,231,2021-01-23T00:00:00,1633,1633,0,1633
ΜΗΛΟΥ,1207,0,0,0,0,2021-01-23T00:00:00,0,0,0,0
ΜΥΚΟΝΟΥ,1208,0,0,0,0,2021-01-23T00:00:00,0,0,0,0
ΝΑΞΟΥ,1209,18,0,-12,18,2021-01-23T00:00:00,180,180,0,180
ΝΗΣΩΝ,906,12,0,-6,12,2021-01-23T00:00:00,118,118,0,118
ΝΟΤΙΟΥ ΤΟΜΕΑ ΑΘΗΝΩΝ,907,278,0,-81,278,2021-01-23T00:00:00,2608,2608,0,2608
ΞΑΝΘΗΣ,105,102,0,-18,102,2021-01-23T00:00:00,1130,1130,0,1130
ΠΑΡΟΥ,1210,0,0,0,0,2021-01-23T00:00:00,0,0,0,0
ΠΕΙΡΑΙΩΣ,908,722,0,11,722,2021-01-23T00:00:00,5765,5765,0,5765
ΠΕΛΛΑΣ,204,193,0,-12,193,2021-01-23T00:00:00,1524,1524,0,1524
ΠΙΕΡΙΑΣ,205,186,0,18,186,2021-01-23T00:00:00,1086,1086,0,1086
ΠΡΕΒΕΖΑΣ,404,72,0,6,72,2021-01-23T00:00:00,663,663,0,663
ΡΕΘΥΜΝΟΥ,1303,126,0,3,126,2021-01-23T00:00:00,1066,1066,0,1066
ΡΟΔΟΠΗΣ,106,96,0,0,96,2021-01-23T00:00:00,777,777,0,777
ΡΟΔΟΥ,1211,96,0,0,96,2021-01-23T00:00:00,909,909,0,909
ΣΑΜΟΥ,1104,36,0,-18,36,2021-01-23T00:00:00,438,438,0,438
ΣΕΡΡΩΝ,206,144,0,-6,144,2021-01-23T00:00:00,1321,1321,0,1321
ΣΠΟΡΑΔΩΝ,504,0,0,0,0,2021-01-23T00:00:00,0,0,0,0
ΣΥΡΟΥ,1212,42,0,-15,42,2021-01-23T00:00:00,394,394,0,394
ΤΗΝΟΥ,1213,0,0,0,0,2021-01-23T00:00:00,0,0,0,0
ΤΡΙΚΑΛΩΝ,505,249,1,-20,250,2021-01-23T00:00:00,1765,1765,1,1766
ΦΘΙΩΤΙΔΑΣ,804,205,0,-28,205,2021-01-23T00:00:00,1621,1621,0,1621
ΦΛΩΡΙΝΑΣ,304,90,0,-12,90,2021-01-23T00:00:00,680,680,0,680
ΦΩΚΙΔΑΣ,805,60,0,0,60,2021-01-23T00:00:00,396,396,0,396
ΧΑΛΚΙΔΙΚΗΣ,207,117,0,-18,117,2021-01-23T00:00:00,773,773,0,773
ΧΑΝΙΩΝ,1304,342,0,-9,342,2021-01-23T00:00:00,2526,2526,0,2526
ΧΙΟΥ,1105,48,0,-30,48,2021-01-23T00:00:00,539,539,0,539
ΑΙΤΩΛΟΑΚΑΡΝΑΝΙΑΣ,701,78,47,-19,125,2021-01-25T00:00:00,1464,1464,47,1511
ΑΝΑΤΟΛΙΚΗΣ ΑΤΤΙΚΗΣ,901,356,96,-8,452,2021-01-25T00:00:00,2576,2576,416,2992
ΑΝΔΡΟΥ,1201,0,0,0,0,2021-01-25T00:00:00,0,0,0,0
ΑΡΓΟΛΙΔΑΣ,1001,143,0,16,143,2021-01-25T00:00:00,1295,1295,0,1295
ΑΡΚΑΔΙΑΣ,1002,180,0,6,180,2021-01-25T00:00:00,1364,1364,0,1364
ΑΡΤΑΣ,401,186,48,48,234,2021-01-25T00:00:00,1456,1456,48,1504
ΑΧΑΪΑΣ,702,366,269,96,635,2021-01-25T00:00:00,4733,4733,668,5401
ΒΟΙΩΤΙΑΣ,801,162,0,30,162,2021-01-25T00:00:00,1213,1213,0,1213
ΒΟΡΕΙΟΥ ΤΟΜΕΑ ΑΘΗΝΩΝ,902,2128,522,1057,2650,2021-01-25T00:00:00,24939,24939,522,25461
ΓΡΕΒΕΝΩΝ,301,48,0,6,48,2021-01-25T00:00:00,515,515,0,515
ΔΡΑΜΑΣ,101,144,0,0,144,2021-01-25T00:00:00,1327,1327,0,1327
ΔΥΤΙΚΗΣ ΑΤΤΙΚΗΣ,903,124,62,-24,186,2021-01-25T00:00:00,1493,1493,293,1786
ΔΥΤΙΚΟΥ ΤΟΜΕΑ ΑΘΗΝΩΝ,904,723,99,-29,822,2021-01-25T00:00:00,6258,6258,401,6659
ΕΒΡΟΥ,102,240,0,0,240,2021-01-25T00:00:00,2845,2845,0,2845
ΕΥΒΟΙΑΣ,802,319,0,81,319,2021-01-25T00:00:00,2552,2552,0,2552
ΕΥΡΥΤΑΝΙΑΣ,803,36,0,18,36,2021-01-25T00:00:00,361,361,0,361
ΖΑΚΥΝΘΟΥ,601,96,0,6,96,2021-01-25T00:00:00,717,717,0,717
ΗΛΕΙΑΣ,703,203,0,46,203,2021-01-25T00:00:00,1709,1709,0,1709
ΗΜΑΘΙΑΣ,201,139,47,0,186,2021-01-25T00:00:00,1647,1647,47,1694
ΗΡΑΚΛΕΙΟΥ,1301,371,132,49,503,2021-01-25T00:00:00,5660,5660,132,5792
ΘΑΣΟΥ,103,0,0,0,0,2021-01-25T00:00:00,0,0,0,0
ΘΕΣΠΡΩΤΙΑΣ,402,114,0,-33,114,2021-01-25T00:00:00,972,972,0,972
ΘΕΣΣΑΛΟΝΙΚΗΣ,202,1133,802,145,1935,2021-01-25T00:00:00,19861,19861,1136,20997
ΘΗΡΑΣ,1202,18,0,12,18,2021-01-25T00:00:00,149,149,0,149
ΙΘΑΚΗΣ,602,0,0,0,0,2021-01-25T00:00:00,0,0,0,0
ΙΚΑΡΙΑΣ,1101,30,0,12,30,2021-01-25T00:00:00,177,177,0,177
ΙΩΑΝΝΙΝΩΝ,403,357,144,80,501,2021-01-25T00:00:00,4459,4459,486,4945
ΚΑΒΑΛΑΣ,104,192,0,0,192,2021-01-25T00:00:00,1766,1766,0,1766
ΚΑΛΥΜΝΟΥ,1203,41,0,6,41,2021-01-25T00:00:00,368,368,0,368
ΚΑΡΔΙΤΣΑΣ,501,184,92,77,276,2021-01-25T00:00:00,1810,1810,92,1902
ΚΑΡΠΑΘΟΥ,1204,24,0,6,24,2021-01-25T00:00:00,117,117,0,117
ΚΑΣΤΟΡΙΑΣ,302,95,0,4,95,2021-01-25T00:00:00,803,803,0,803
ΚΕΑΣ-ΚΥΘΝΟΥ,1205,0,0,0,0,2021-01-25T00:00:00,0,0,0,0
ΚΕΝΤΡΙΚΟΥ ΤΟΜΕΑ ΑΘΗΝΩΝ,905,1235,1733,1144,2968,2021-01-25T00:00:00,28578,28578,2479,31057
ΚΕΡΚΥΡΑΣ,603,229,0,-27,229,2021-01-25T00:00:00,1622,1622,0,1622
ΚΕΦΑΛΛΗΝΙΑΣ,604,95,0,38,95,2021-01-25T00:00:00,868,868,0,868
ΚΙΛΚΙΣ,203,150,0,48,150,2021-01-25T00:00:00,1254,1254,0,1254
ΚΟΖΑΝΗΣ,303,75,122,5,197,2021-01-25T00:00:00,1623,1623,122,1745
ΚΟΡΙΝΘΙΑΣ,1003,125,48,41,173,2021-01-25T00:00:00,955,955,48,1003
ΚΩ,1206,53,0,23,53,2021-01-25T00:00:00,438,438,0,438
ΛΑΚΩΝΙΑΣ,1004,185,0,42,185,2021-01-25T00:00:00,1446,1446,0,1446
ΛΑΡΙΣΑΣ,502,342,189,41,531,2021-01-25T00:00:00,3606,3606,649,4255
ΛΑΣΙΘΙΟΥ,1302,210,0,12,210,2021-01-25T00:00:00,1916,1916,0,1916
ΛΕΣΒΟΥ,1102,156,0,12,156,2021-01-25T00:00:00,1231,1231,0,1231
ΛΕΥΚΑΔΑΣ,605,72,0,0,72,2021-01-25T00:00:00,495,495,0,495
ΛΗΜΝΟΥ,1103,42,0,0,42,2021-01-25T00:00:00,407,407,0,407
ΜΑΓΝΗΣΙΑΣ,503,217,0,43,217,2021-01-25T00:00:00,1425,1425,0,1425
ΜΕΣΣΗΝΙΑΣ,1005,363,0,132,363,2021-01-25T00:00:00,1996,1996,0,1996
ΜΗΛΟΥ,1207,0,0,0,0,2021-01-25T00:00:00,0,0,0,0
ΜΥΚΟΝΟΥ,1208,0,0,0,0,2021-01-25T00:00:00,0,0,0,0
ΝΑΞΟΥ,1209,24,0,6,24,2021-01-25T00:00:00,204,204,0,204
ΝΗΣΩΝ,906,12,0,0,12,2021-01-25T00:00:00,130,130,0,130
ΝΟΤΙΟΥ ΤΟΜΕΑ ΑΘΗΝΩΝ,907,289,0,11,289,2021-01-25T00:00:00,2897,2897,0,2897
ΞΑΝΘΗΣ,105,96,0,-6,96,2021-01-25T00:00:00,1226,1226,0,1226
ΠΑΡΟΥ,1210,0,0,0,0,2021-01-25T00:00:00,0,0,0,0
ΠΕΙΡΑΙΩΣ,908,644,93,15,737,2021-01-25T00:00:00,6409,6409,93,6502
ΠΕΛΛΑΣ,204,146,94,47,240,2021-01-25T00:00:00,1670,1670,94,1764
ΠΙΕΡΙΑΣ,205,86,94,-6,180,2021-01-25T00:00:00,1172,1172,94,1266
ΠΡΕΒΕΖΑΣ,404,72,0,0,72,2021-01-25T00:00:00,735,735,0,735
ΡΕΘΥΜΝΟΥ,1303,144,0,18,144,2021-01-25T00:00:00,1210,1210,0,1210
ΡΟΔΟΠΗΣ,106,96,0,0,96,2021-01-25T00:00:00,873,873,0,873
ΡΟΔΟΥ,1211,234,0,138,234,2021-01-25T00:00:00,1143,1143,0,1143
ΣΑΜΟΥ,1104,47,1,12,48,2021-01-25T00:00:00,485,485,1,486
ΣΕΡΡΩΝ,206,144,0,0,144,2021-01-25T00:00:00,1465,1465,0,1465
ΣΠΟΡΑΔΩΝ,504,0,0,0,0,2021-01-25T00:00:00,0,0,0,0
ΣΥΡΟΥ,1212,60,0,18,60,2021-01-25T00:00:00,454,454,0,454
ΤΗΝΟΥ,1213,0,0,0,0,2021-01-25T00:00:00,0,0,0,0
ΤΡΙΚΑΛΩΝ,505,227,96,73,323,2021-01-25T00:00:00,1992,1992,97,2089
ΦΘΙΩΤΙΔΑΣ,804,222,0,17,222,2021-01-25T00:00:00,1843,1843,0,1843
ΦΛΩΡΙΝΑΣ,304,96,0,6,96,2021-01-25T00:00:00,776,776,0,776
ΦΩΚΙΔΑΣ,805,54,0,-6,54,2021-01-25T00:00:00,450,450,0,450
ΧΑΛΚΙΔΙΚΗΣ,207,122,2,7,124,2021-01-25T00:00:00,895,895,2,897
ΧΑΝΙΩΝ,1304,282,94,34,376,2021-01-25T00:00:00,2808,2808,94,2902
ΧΙΟΥ,1105,48,0,0,48,2021-01-25T00:00:00,587,587,0,587
ΑΙΤΩΛΟΑΚΑΡΝΑΝΙΑΣ,701,171,47,93,218,2021-01-26T00:00:00,1635,1635,94,1729
ΑΝΑΤΟΛΙΚΗΣ ΑΤΤΙΚΗΣ,901,415,53,16,468,2021-01-26T00:00:00,2991,2991,469,3460
ΑΝΔΡΟΥ,1201,0,0,0,0,2021-01-26T00:00:00,0,0,0,0
ΑΡΓΟΛΙΔΑΣ,1001,126,0,-17,126,2021-01-26T00:00:00,1421,1421,0,1421
ΑΡΚΑΔΙΑΣ,1002,124,0,-56,124,2021-01-26T00:00:00,1488,1488,0,1488
ΑΡΤΑΣ,401,96,48,-90,144,2021-01-26T00:00:00,1552,1552,96,1648
ΑΧΑΪΑΣ,702,262,242,-131,504,2021-01-26T00:00:00,4995,4995,910,5905
ΒΟΙΩΤΙΑΣ,801,120,0,-42,120,2021-01-26T00:00:00,1333,1333,0,1333
ΒΟΡΕΙΟΥ ΤΟΜΕΑ ΑΘΗΝΩΝ,902,1692,612,-346,2304,2021-01-26T00:00:00,26631,26631,1134,27765
ΓΡΕΒΕΝΩΝ,301,54,0,6,54,2021-01-26T00:00:00,569,569,0,569
ΔΡΑΜΑΣ,101,144,0,0,144,2021-01-26T00:00:00,1471,1471,0,1471
ΔΥΤΙΚΗΣ ΑΤΤΙΚΗΣ,903,93,39,-54,132,2021-01-26T00:00:00,1586,1586,332,1918
ΔΥΤΙΚΟΥ ΤΟΜΕΑ ΑΘΗΝΩΝ,904,680,94,-48,774,2021-01-26T00:00:00,6938,6938,495,7433
ΕΒΡΟΥ,102,234,0,-6,234,2021-01-26T00:00:00,3079,3079,0,3079
ΕΥΒΟΙΑΣ,802,275,0,-44,275,2021-01-26T00:00:00,2827,2827,0,2827
ΕΥΡΥΤΑΝΙΑΣ,803,18,0,-18,18,2021-01-26T00:00:00,379,379,0,379
ΖΑΚΥΝΘΟΥ,601,47,0,-49,47,2021-01-26T00:00:00,764,764,0,764
ΗΛΕΙΑΣ,703,154,0,-49,154,2021-01-26T00:00:00,1863,1863,0,1863
ΗΜΑΘΙΑΣ,201,165,47,26,212,2021-01-26T00:00:00,1812,1812,94,1906
ΗΡΑΚΛΕΙΟΥ,1301,288,122,-93,410,2021-01-26T00:00:00,5948,5948,254,6202
ΘΑΣΟΥ,103,0,0,0,0,2021-01-26T00:00:00,0,0,0,0
ΘΕΣΠΡΩΤΙΑΣ,402,90,0,-24,90,2021-01-26T00:00:00,1062,1062,0,1062
ΘΕΣΣΑΛΟΝΙΚΗΣ,202,1117,896,78,2013,2021-01-26T00:00:00,20978,20978,2032,23010
ΘΗΡΑΣ,1202,18,0,0,18,2021-01-26T00:00:00,167,167,0,167
ΙΘΑΚΗΣ,602,0,0,0,0,2021-01-26T00:00:00,0,0,0,0
ΙΚΑΡΙΑΣ,1101,12,0,-18,12,2021-01-26T00:00:00,189,189,0,189
ΙΩΑΝΝΙΝΩΝ,403,148,236,-117,384,2021-01-26T00:00:00,4607,4607,722,5329
ΚΑΒΑΛΑΣ,104,198,0,6,198,2021-01-26T00:00:00,1964,1964,0,1964
ΚΑΛΥΜΝΟΥ,1203,11,0,-30,11,2021-01-26T00:00:00,379,379,0,379
ΚΑΡΔΙΤΣΑΣ,501,73,95,-108,168,2021-01-26T00:00:00,1883,1883,187,2070
ΚΑΡΠΑΘΟΥ,1204,30,0,6,30,2021-01-26T00:00:00,147,147,0,147
ΚΑΣΤΟΡΙΑΣ,302,106,0,11,106,2021-01-26T00:00:00,909,909,0,909
ΚΕΑΣ-ΚΥΘΝΟΥ,1205,0,0,0,0,2021-01-26T00:00:00,0,0,0,0
ΚΕΝΤΡΙΚΟΥ ΤΟΜΕΑ ΑΘΗΝΩΝ,905,1314,1725,71,3039,2021-01-26T00:00:00,29892,29892,4204,34096
ΚΕΡΚΥΡΑΣ,603,144,0,-85,144,2021-01-26T00:00:00,1766,1766,0,1766
ΚΕΦΑΛΛΗΝΙΑΣ,604,54,0,-41,54,2021-01-26T00:00:00,922,922,0,922
ΚΙΛΚΙΣ,203,114,0,-36,114,2021-01-26T00:00:00,1368,1368,0,1368
ΚΟΖΑΝΗΣ,303,104,101,8,205,2021-01-26T00:00:00,1727,1727,223,1950
ΚΟΡΙΝΘΙΑΣ,1003,121,46,-6,167,2021-01-26T00:00:00,1076,1076,94,1170
ΚΩ,1206,36,0,-17,36,2021-01-26T00:00:00,474,474,0,474
ΛΑΚΩΝΙΑΣ,1004,127,0,-58,127,2021-01-26T00:00:00,1573,1573,0,1573
ΛΑΡΙΣΑΣ,502,158,189,-184,347,2021-01-26T00:00:00,3764,3764,838,4602
ΛΑΣΙΘΙΟΥ,1302,203,0,-7,203,2021-01-26T00:00:00,2119,2119,0,2119
ΛΕΣΒΟΥ,1102,114,0,-42,114,2021-01-26T00:00:00,1345,1345,0,1345
ΛΕΥΚΑΔΑΣ,605,42,0,-30,42,2021-01-26T00:00:00,537,537,0,537
ΛΗΜΝΟΥ,1103,24,0,-18,24,2021-01-26T00:00:00,431,431,0,431
ΜΑΓΝΗΣΙΑΣ,503,233,0,16,233,2021-01-26T00:00:00,1658,1658,0,1658
ΜΕΣΣΗΝΙΑΣ,1005,254,0,-109,254,2021-01-26T00:00:00,2250,2250,0,2250
ΜΗΛΟΥ,1207,0,0,0,0,2021-01-26T00:00:00,0,0,0,0
ΜΥΚΟΝΟΥ,1208,0,0,0,0,2021-01-26T00:00:00,0,0,0,0
ΝΑΞΟΥ,1209,24,0,0,24,2021-01-26T00:00:00,228,228,0,228
ΝΗΣΩΝ,906,0,0,-12,0,2021-01-26T00:00:00,130,130,0,130
ΝΟΤΙΟΥ ΤΟΜΕΑ ΑΘΗΝΩΝ,907,335,0,46,335,2021-01-26T00:00:00,3232,3232,0,3232
ΞΑΝΘΗΣ,105,96,0,0,96,2021-01-26T00:00:00,1322,1322,0,1322
ΠΑΡΟΥ,1210,0,0,0,0,2021-01-26T00:00:00,0,0,0,0
ΠΕΙΡΑΙΩΣ,908,647,89,-1,736,2021-01-26T00:00:00,7056,7056,182,7238
ΠΕΛΛΑΣ,204,133,71,-36,204,2021-01-26T00:00:00,1803,1803,165,1968
ΠΙΕΡΙΑΣ,205,120,91,31,211,2021-01-26T00:00:00,1292,1292,185,1477
ΠΡΕΒΕΖΑΣ,404,48,0,-24,48,2021-01-26T00:00:00,783,783,0,783
ΡΕΘΥΜΝΟΥ,1303,130,0,-14,130,2021-01-26T00:00:00,1340,1340,0,1340
ΡΟΔΟΠΗΣ,106,102,0,6,102,2021-01-26T00:00:00,975,975,0,975
ΡΟΔΟΥ,1211,90,0,-144,90,2021-01-26T00:00:00,1233,1233,0,1233
ΣΑΜΟΥ,1104,36,0,-12,36,2021-01-26T00:00:00,521,521,1,522
ΣΕΡΡΩΝ,206,144,0,0,144,2021-01-26T00:00:00,1609,1609,0,1609
ΣΠΟΡΑΔΩΝ,504,0,0,0,0,2021-01-26T00:00:00,0,0,0,0
ΣΥΡΟΥ,1212,36,0,-24,36,2021-01-26T00:00:00,490,490,0,490
ΤΗΝΟΥ,1213,0,0,0,0,2021-01-26T00:00:00,0,0,0,0
ΤΡΙΚΑΛΩΝ,505,118,86,-119,204,2021-01-26T00:00:00,2110,2110,183,2293
ΦΘΙΩΤΙΔΑΣ,804,162,0,-60,162,2021-01-26T00:00:00,2005,2005,0,2005
ΦΛΩΡΙΝΑΣ,304,86,0,-10,86,2021-01-26T00:00:00,862,862,0,862
ΦΩΚΙΔΑΣ,805,54,0,0,54,2021-01-26T00:00:00,504,504,0,504
ΧΑΛΚΙΔΙΚΗΣ,207,96,0,-28,96,2021-01-26T00:00:00,991,991,2,993
ΧΑΝΙΩΝ,1304,212,155,-9,367,2021-01-26T00:00:00,3020,3020,249,3269
ΧΙΟΥ,1105,48,0,0,48,2021-01-26T00:00:00,635,635,0,635
ΑΙΤΩΛΟΑΚΑΡΝΑΝΙΑΣ,701,145,51,-22,196,2021-01-27T00:00:00,1780,1780,145,1925
ΑΝΑΤΟΛΙΚΗΣ ΑΤΤΙΚΗΣ,901,404,62,-2,466,2021-01-27T00:00:00,3395,3395,531,3926
ΑΝΔΡΟΥ,1201,0,0,0,0,2021-01-27T00:00:00,0,0,0,0
ΑΡΓΟΛΙΔΑΣ,1001,148,0,22,148,2021-01-27T00:00:00,1569,1569,0,1569
ΑΡΚΑΔΙΑΣ,1002,132,0,8,132,2021-01-27T00:00:00,1620,1620,0,1620
ΑΡΤΑΣ,401,91,47,-6,138,2021-01-27T00:00:00,1643,1643,143,1786
ΑΧΑΪΑΣ,702,345,189,30,534,2021-01-27T00:00:00,5340,5340,1099,6439
ΒΟΙΩΤΙΑΣ,801,155,0,35,155,2021-01-27T00:00:00,1488,1488,0,1488
ΒΟΡΕΙΟΥ ΤΟΜΕΑ ΑΘΗΝΩΝ,902,1079,505,-720,1584,2021-01-27T00:00:00,27710,27710,1639,29349
ΓΡΕΒΕΝΩΝ,301,48,0,-6,48,2021-01-27T00:00:00,617,617,0,617
ΔΡΑΜΑΣ,101,150,0,6,150,2021-01-27T00:00:00,1621,1621,0,1621
ΔΥΤΙΚΗΣ ΑΤΤΙΚΗΣ,903,172,2,42,174,2021-01-27T00:00:00,1758,1758,334,2092
ΔΥΤΙΚΟΥ ΤΟΜΕΑ ΑΘΗΝΩΝ,904,589,149,-36,738,2021-01-27T00:00:00,7527,7527,644,8171
ΕΒΡΟΥ,102,245,0,11,245,2021-01-27T00:00:00,3324,3324,0,3324
ΕΥΒΟΙΑΣ,802,390,0,115,390,2021-01-27T00:00:00,3217,3217,0,3217
ΕΥΡΥΤΑΝΙΑΣ,803,30,0,12,30,2021-01-27T00:00:00,409,409,0,409
ΖΑΚΥΝΘΟΥ,601,61,0,14,61,2021-01-27T00:00:00,825,825,0,825
ΗΛΕΙΑΣ,703,203,0,49,203,2021-01-27T00:00:00,2066,2066,0,2066
ΗΜΑΘΙΑΣ,201,150,48,-14,198,2021-01-27T00:00:00,1962,1962,142,2104
ΗΡΑΚΛΕΙΟΥ,1301,355,117,62,472,2021-01-27T00:00:00,6303,6303,371,6674
ΘΑΣΟΥ,103,0,0,0,0,2021-01-27T00:00:00,0,0,0,0
ΘΕΣΠΡΩΤΙΑΣ,402,102,0,12,102,2021-01-27T00:00:00,1164,1164,0,1164
ΘΕΣΣΑΛΟΝΙΚΗΣ,202,1285,782,54,2067,2021-01-27T00:00:00,22263,22263,2814,25077
ΘΗΡΑΣ,1202,18,0,0,18,2021-01-27T00:00:00,185,185,0,185
ΙΘΑΚΗΣ,602,0,0,0,0,2021-01-27T00:00:00,0,0,0,0
ΙΚΑΡΙΑΣ,1101,12,0,0,12,2021-01-27T00:00:00,201,201,0,201
ΙΩΑΝΝΙΝΩΝ,403,258,173,47,431,2021-01-27T00:00:00,4865,4865,895,5760
ΚΑΒΑΛΑΣ,104,203,2,7,205,2021-01-27T00:00:00,2167,2167,2,2169
ΚΑΛΥΜΝΟΥ,1203,60,0,49,60,2021-01-27T00:00:00,439,439,0,439
ΚΑΡΔΙΤΣΑΣ,501,127,95,54,222,2021-01-27T00:00:00,2010,2010,282,2292
ΚΑΡΠΑΘΟΥ,1204,0,0,-30,0,2021-01-27T00:00:00,147,147,0,147
ΚΑΣΤΟΡΙΑΣ,302,96,0,-10,96,2021-01-27T00:00:00,1005,1005,0,1005
ΚΕΑΣ-ΚΥΘΝΟΥ,1205,0,0,0,0,2021-01-27T00:00:00,0,0,0,0
ΚΕΝΤΡΙΚΟΥ ΤΟΜΕΑ ΑΘΗΝΩΝ,905,1645,1632,238,3277,2021-01-27T00:00:00,31537,31537,5836,37373
ΚΕΡΚΥΡΑΣ,603,132,0,-12,132,2021-01-27T00:00:00,1898,1898,0,1898
ΚΕΦΑΛΛΗΝΙΑΣ,604,90,0,36,90,2021-01-27T00:00:00,1012,1012,0,1012
ΚΙΛΚΙΣ,203,138,0,24,138,2021-01-27T00:00:00,1506,1506,0,1506
ΚΟΖΑΝΗΣ,303,114,90,-1,204,2021-01-27T00:00:00,1841,1841,313,2154
ΚΟΡΙΝΘΙΑΣ,1003,102,48,-17,150,2021-01-27T00:00:00,1178,1178,142,1320
ΚΩ,1206,41,1,6,42,2021-01-27T00:00:00,515,515,1,516
ΛΑΚΩΝΙΑΣ,1004,129,2,4,131,2021-01-27T00:00:00,1702,1702,2,1704
ΛΑΡΙΣΑΣ,502,167,183,3,350,2021-01-27T00:00:00,3931,3931,1021,4952
ΛΑΣΙΘΙΟΥ,1302,258,0,55,258,2021-01-27T00:00:00,2377,2377,0,2377
ΛΕΣΒΟΥ,1102,132,0,18,132,2021-01-27T00:00:00,1477,1477,0,1477
ΛΕΥΚΑΔΑΣ,605,36,0,-6,36,2021-01-27T00:00:00,573,573,0,573
ΛΗΜΝΟΥ,1103,36,0,12,36,2021-01-27T00:00:00,467,467,0,467
ΜΑΓΝΗΣΙΑΣ,503,270,0,37,270,2021-01-27T00:00:00,1928,1928,0,1928
ΜΕΣΣΗΝΙΑΣ,1005,240,0,-14,240,2021-01-27T00:00:00,2490,2490,0,2490
ΜΗΛΟΥ,1207,0,0,0,0,2021-01-27T00:00:00,0,0,0,0
ΜΥΚΟΝΟΥ,1208,0,0,0,0,2021-01-27T00:00:00,0,0,0,0
ΝΑΞΟΥ,1209,30,0,6,30,2021-01-27T00:00:00,258,258,0,258
ΝΗΣΩΝ,906,18,0,18,18,2021-01-27T00:00:00,148,148,0,148
ΝΟΤΙΟΥ ΤΟΜΕΑ ΑΘΗΝΩΝ,907,276,0,-59,276,2021-01-27T00:00:00,3508,3508,0,3508
ΞΑΝΘΗΣ,105,96,0,0,96,2021-01-27T00:00:00,1418,1418,0,1418
ΠΑΡΟΥ,1210,0,0,0,0,2021-01-27T00:00:00,0,0,0,0
ΠΕΙΡΑΙΩΣ,908,612,91,-33,703,2021-01-27T00:00:00,7668,7668,273,7941
ΠΕΛΛΑΣ,204,196,110,102,306,2021-01-27T00:00:00,1999,1999,275,2274
ΠΙΕΡΙΑΣ,205,116,69,-26,185,2021-01-27T00:00:00,1408,1408,254,1662
ΠΡΕΒΕΖΑΣ,404,51,0,3,51,2021-01-27T00:00:00,834,834,0,834
ΡΕΘΥΜΝΟΥ,1303,138,0,8,138,2021-01-27T00:00:00,1478,1478,0,1478
ΡΟΔΟΠΗΣ,106,96,0,-6,96,2021-01-27T00:00:00,1071,1071,0,1071
ΡΟΔΟΥ,1211,244,0,154,244,2021-01-27T00:00:00,1477,1477,0,1477
ΣΑΜΟΥ,1104,41,1,6,42,2021-01-27T00:00:00,562,562,2,564
ΣΕΡΡΩΝ,206,150,0,6,150,2021-01-27T00:00:00,1759,1759,0,1759
ΣΠΟΡΑΔΩΝ,504,0,0,0,0,2021-01-27T00:00:00,0,0,0,0
ΣΥΡΟΥ,1212,42,0,6,42,2021-01-27T00:00:00,532,532,0,532
ΤΗΝΟΥ,1213,0,0,0,0,2021-01-27T00:00:00,0,0,0,0
ΤΡΙΚΑΛΩΝ,505,96,101,-7,197,2021-01-27T00:00:00,2206,2206,284,2490
ΦΘΙΩΤΙΔΑΣ,804,192,0,30,192,2021-01-27T00:00:00,2197,2197,0,2197
ΦΛΩΡΙΝΑΣ,304,96,0,10,96,2021-01-27T00:00:00,958,958,0,958
ΦΩΚΙΔΑΣ,805,54,0,0,54,2021-01-27T00:00:00,558,558,0,558
ΧΑΛΚΙΔΙΚΗΣ,207,144,0,48,144,2021-01-27T00:00:00,1135,1135,2,1137
ΧΑΝΙΩΝ,1304,232,184,49,416,2021-01-27T00:00:00,3252,3252,433,3685
ΧΙΟΥ,1105,48,0,0,48,2021-01-27T00:00:00,683,683,0,683
ΑΙΤΩΛΟΑΚΑΡΝΑΝΙΑΣ,701,225,181,2,406,2021-02-25T00:00:00,6602,6602,2624,9226
ΑΝΑΤΟΛΙΚΗΣ ΑΤΤΙΚΗΣ,901,448,532,80,980,2021-02-25T00:00:00,12944,12944,6515,19459
ΑΝΔΡΟΥ,1201,0,12,-31,12,2021-02-25T00:00:00,297,297,243,540
ΑΡΓΟΛΙΔΑΣ,1001,92,152,-25,244,2021-02-25T00:00:00,4197,4197,2379,6576
ΑΡΚΑΔΙΑΣ,1002,142,146,5,288,2021-02-25T00:00:00,4208,4208,2267,6475
ΑΡΤΑΣ,401,30,138,-25,168,2021-02-25T00:00:00,3828,3828,2319,6147
ΑΧΑΪΑΣ,702,222,489,36,711,2021-02-25T00:00:00,12055,12055,8138,20193
ΒΟΙΩΤΙΑΣ,801,286,107,10,393,2021-02-25T00:00:00,5203,5203,2191,7394
ΒΟΡΕΙΟΥ ΤΟΜΕΑ ΑΘΗΝΩΝ,902,3583,1348,-355,4931,2021-02-25T00:00:00,77241,77241,35552,112793
ΓΡΕΒΕΝΩΝ,301,56,48,24,104,2021-02-25T00:00:00,1743,1743,777,2520
ΔΡΑΜΑΣ,101,129,147,31,276,2021-02-25T00:00:00,4297,4297,2296,6593
ΔΥΤΙΚΗΣ ΑΤΤΙΚΗΣ,903,153,57,-2,210,2021-02-25T00:00:00,4040,4040,2785,6825
ΔΥΤΙΚΟΥ ΤΟΜΕΑ ΑΘΗΝΩΝ,904,485,583,45,1068,2021-02-25T00:00:00,20745,20745,11333,32078
ΕΒΡΟΥ,102,273,165,5,438,2021-02-25T00:00:00,7704,7704,4207,11911
ΕΥΒΟΙΑΣ,802,243,246,-37,489,2021-02-25T00:00:00,8040,8040,5030,13070
ΕΥΡΥΤΑΝΙΑΣ,803,28,25,-17,53,2021-02-25T00:00:00,954,954,553,1507
ΖΑΚΥΝΘΟΥ,601,36,18,-5,54,2021-02-25T00:00:00,1521,1521,1155,2676
ΗΛΕΙΑΣ,703,154,192,4,346,2021-02-25T00:00:00,4930,4930,3123,8053
ΗΜΑΘΙΑΣ,201,177,189,1,366,2021-02-25T00:00:00,6210,6210,2962,9172
ΗΡΑΚΛΕΙΟΥ,1301,456,256,-14,712,2021-02-25T00:00:00,12913,12913,8137,21050
ΘΑΣΟΥ,103,1,41,0,42,2021-02-25T00:00:00,430,430,313,743
ΘΕΣΠΡΩΤΙΑΣ,402,80,103,37,183,2021-02-25T00:00:00,2778,2778,1625,4403
ΘΕΣΣΑΛΟΝΙΚΗΣ,202,2231,1561,145,3792,2021-02-25T00:00:00,61980,61980,31236,93216
ΘΗΡΑΣ,1202,3,3,-12,6,2021-02-25T00:00:00,395,395,300,695
ΙΘΑΚΗΣ,602,0,0,0,0,2021-02-25T00:00:00,128,128,3,131
ΙΚΑΡΙΑΣ,1101,16,8,-11,24,2021-02-25T00:00:00,823,823,346,1169
ΙΩΑΝΝΙΝΩΝ,403,256,232,10,488,2021-02-25T00:00:00,10249,10249,6225,16474
ΚΑΒΑΛΑΣ,104,123,199,38,322,2021-02-25T00:00:00,5501,5501,3074,8575
ΚΑΛΥΜΝΟΥ,1203,13,4,-1,17,2021-02-25T00:00:00,745,745,653,1398
ΚΑΡΔΙΤΣΑΣ,501,199,217,-61,416,2021-02-25T00:00:00,6420,6420,3322,9742
ΚΑΡΠΑΘΟΥ,1204,6,6,-1,12,2021-02-25T00:00:00,278,278,245,523
ΚΑΣΤΟΡΙΑΣ,302,107,69,35,176,2021-02-25T00:00:00,2767,2767,1438,4205
ΚΕΑΣ-ΚΥΘΝΟΥ,1205,0,0,0,0,2021-02-25T00:00:00,44,44,0,44
ΚΕΝΤΡΙΚΟΥ ΤΟΜΕΑ ΑΘΗΝΩΝ,905,1816,2407,277,4223,2021-02-25T00:00:00,78879,78879,44462,123341
ΚΕΡΚΥΡΑΣ,603,67,95,3,162,2021-02-25T00:00:00,3867,3867,2539,6406
ΚΕΦΑΛΛΗΝΙΑΣ,604,45,67,95,112,2021-02-25T00:00:00,2173,2173,1560,3733
ΚΙΛΚΙΣ,203,135,119,-12,254,2021-02-25T00:00:00,4073,4073,2224,6297
ΚΟΖΑΝΗΣ,303,226,183,71,409,2021-02-25T00:00:00,6415,6415,2905,9320
ΚΟΡΙΝΘΙΑΣ,1003,178,153,5,331,2021-02-25T00:00:00,4920,4920,2072,6992
ΚΩ,1206,58,5,17,63,2021-02-25T00:00:00,1592,1592,896,2488
ΛΑΚΩΝΙΑΣ,1004,107,149,-28,256,2021-02-25T00:00:00,4466,4466,2353,6819
ΛΑΡΙΣΑΣ,502,284,358,-42,642,2021-02-25T00:00:00,11958,11958,5787,17745
ΛΑΣΙΘΙΟΥ,1302,100,138,-5,238,2021-02-25T00:00:00,4823,4823,3573,8396
ΛΕΣΒΟΥ,1102,85,75,44,160,2021-02-25T00:00:00,3055,3055,2236,5291
ΛΕΥΚΑΔΑΣ,605,54,45,3,99,2021-02-25T00:00:00,1977,1977,833,2810
ΛΗΜΝΟΥ,1103,15,3,6,18,2021-02-25T00:00:00,809,809,642,1451
ΜΑΓΝΗΣΙΑΣ,503,250,151,8,401,2021-02-25T00:00:00,6543,6543,3323,9866
ΜΕΣΣΗΝΙΑΣ,1005,136,260,-39,396,2021-02-25T00:00:00,6931,6931,3801,10732
ΜΗΛΟΥ,1207,1,17,-4,18,2021-02-25T00:00:00,297,297,107,404
ΜΥΚΟΝΟΥ,1208,0,0,0,0,2021-02-25T00:00:00,165,165,142,307
ΝΑΞΟΥ,1209,12,12,0,24,2021-02-25T00:00:00,470,470,405,875
ΝΗΣΩΝ,906,21,107,-10,128,2021-02-25T00:00:00,1954,1954,1334,3288
ΝΟΤΙΟΥ ΤΟΜΕΑ ΑΘΗΝΩΝ,907,518,278,-63,796,2021-02-25T00:00:00,12746,12746,5444,18190
ΞΑΝΘΗΣ,105,99,111,4,210,2021-02-25T00:00:00,3310,3310,1891,5201
ΠΑΡΟΥ,1210,0,30,-6,30,2021-02-25T00:00:00,304,304,260,564
ΠΕΙΡΑΙΩΣ,908,775,597,-1,1372,2021-02-25T00:00:00,20241,20241,10998,31239
ΠΕΛΛΑΣ,204,158,293,32,451,2021-02-25T00:00:00,6807,6807,3616,10423
ΠΙΕΡΙΑΣ,205,99,203,63,302,2021-02-25T00:00:00,4637,4637,2653,7290
ΠΡΕΒΕΖΑΣ,404,117,50,5,167,2021-02-25T00:00:00,2500,2500,947,3447
ΡΕΘΥΜΝΟΥ,1303,230,21,-18,251,2021-02-25T00:00:00,3803,3803,2184,5987
ΡΟΔΟΠΗΣ,106,124,75,52,199,2021-02-25T00:00:00,3158,3158,1491,4649
ΡΟΔΟΥ,1211,161,7,-23,168,2021-02-25T00:00:00,3895,3895,1951,5846
ΣΑΜΟΥ,1104,50,7,11,57,2021-02-25T00:00:00,1294,1294,745,2039
ΣΕΡΡΩΝ,206,287,115,-24,402,2021-02-25T00:00:00,6514,6514,2310,8824
ΣΠΟΡΑΔΩΝ,504,0,0,-6,0,2021-02-25T00:00:00,286,286,200,486
ΣΥΡΟΥ,1212,19,5,18,24,2021-02-25T00:00:00,928,928,681,1609
ΤΗΝΟΥ,1213,3,21,-6,24,2021-02-25T00:00:00,309,309,260,569
ΤΡΙΚΑΛΩΝ,505,173,212,-13,385,2021-02-25T00:00:00,6992,6992,3265,10257
ΦΘΙΩΤΙΔΑΣ,804,275,37,47,312,2021-02-25T00:00:00,5354,5354,2732,8086
ΦΛΩΡΙΝΑΣ,304,72,95,20,167,2021-02-25T00:00:00,2351,2351,1384,3735
ΦΩΚΙΔΑΣ,805,47,50,-26,97,2021-02-25T00:00:00,1594,1594,795,2389
ΧΑΛΚΙΔΙΚΗΣ,207,206,90,-17,296,2021-02-25T00:00:00,4259,4259,1721,5980
ΧΑΝΙΩΝ,1304,185,341,-43,526,2021-02-25T00:00:00,8545,8545,5303,13848
ΧΙΟΥ,1105,88,38,-6,126,2021-02-25T00:00:00,2635,2635,940,3575
ΑΙΤΩΛΟΑΚΑΡΝΑΝΙΑΣ,701,213,193,0,406,2021-02-26T00:00:00,6815,6815,2817,9632
ΑΝΑΤΟΛΙΚΗΣ ΑΤΤΙΚΗΣ,901,439,530,-11,969,2021-02-26T00:00:00,13383,13383,7045,20428
ΑΝΔΡΟΥ,1201,0,17,5,17,2021-02-26T00:00:00,297,297,260,557
ΑΡΓΟΛΙΔΑΣ,1001,115,159,30,274,2021-02-26T00:00:00,4312,4312,2538,6850
ΑΡΚΑΔΙΑΣ,1002,144,146,2,290,2021-02-26T00:00:00,4352,4352,2413,6765
ΑΡΤΑΣ,401,46,143,21,189,2021-02-26T00:00:00,3874,3874,2462,6336
ΑΧΑΪΑΣ,702,273,438,0,711,2021-02-26T00:00:00,12328,12328,8576,20904
ΒΟΙΩΤΙΑΣ,801,265,106,-22,371,2021-02-26T00:00:00,5468,5468,2297,7765
ΒΟΡΕΙΟΥ ΤΟΜΕΑ ΑΘΗΝΩΝ,902,3300,1332,-299,4632,2021-02-26T00:00:00,80541,80541,36884,117425
ΓΡΕΒΕΝΩΝ,301,71,53,20,124,2021-02-26T00:00:00,1814,1814,830,2644
ΔΡΑΜΑΣ,101,75,149,-52,224,2021-02-26T00:00:00,4372,4372,2445,6817
ΔΥΤΙΚΗΣ ΑΤΤΙΚΗΣ,903,129,38,-43,167,2021-02-26T00:00:00,4169,4169,2823,6992
ΔΥΤΙΚΟΥ ΤΟΜΕΑ ΑΘΗΝΩΝ,904,408,565,-95,973,2021-02-26T00:00:00,21153,21153,11898,33051
ΕΒΡΟΥ,102,201,166,-71,367,2021-02-26T00:00:00,7905,7905,4373,12278
ΕΥΒΟΙΑΣ,802,304,218,33,522,2021-02-26T00:00:00,8344,8344,5248,13592
ΕΥΡΥΤΑΝΙΑΣ,803,34,38,19,72,2021-02-26T00:00:00,988,988,591,1579
ΖΑΚΥΝΘΟΥ,601,7,51,4,58,2021-02-26T00:00:00,1528,1528,1206,2734
ΗΛΕΙΑΣ,703,144,167,-35,311,2021-02-26T00:00:00,5074,5074,3290,8364
ΗΜΑΘΙΑΣ,201,164,205,3,369,2021-02-26T00:00:00,6374,6374,3167,9541
ΗΡΑΚΛΕΙΟΥ,1301,397,285,-30,682,2021-02-26T00:00:00,13310,13310,8422,21732
ΘΑΣΟΥ,103,0,30,-12,30,2021-02-26T00:00:00,430,430,343,773
ΘΕΣΠΡΩΤΙΑΣ,402,65,107,-11,172,2021-02-26T00:00:00,2843,2843,1732,4575
ΘΕΣΣΑΛΟΝΙΚΗΣ,202,2079,1548,-165,3627,2021-02-26T00:00:00,64059,64059,32784,96843
ΘΗΡΑΣ,1202,1,5,0,6,2021-02-26T00:00:00,396,396,305,701
ΙΘΑΚΗΣ,602,0,0,0,0,2021-02-26T00:00:00,128,128,3,131
ΙΚΑΡΙΑΣ,1101,25,45,46,70,2021-02-26T00:00:00,848,848,391,1239
ΙΩΑΝΝΙΝΩΝ,403,263,266,41,529,2021-02-26T00:00:00,10512,10512,6491,17003
ΚΑΒΑΛΑΣ,104,81,203,-38,284,2021-02-26T00:00:00,5582,5582,3277,8859
ΚΑΛΥΜΝΟΥ,1203,207,8,198,215,2021-02-26T00:00:00,952,952,661,1613
ΚΑΡΔΙΤΣΑΣ,501,289,174,47,463,2021-02-26T00:00:00,6709,6709,3496,10205
ΚΑΡΠΑΘΟΥ,1204,0,0,-12,0,2021-02-26T00:00:00,278,278,245,523
ΚΑΣΤΟΡΙΑΣ,302,53,100,-23,153,2021-02-26T00:00:00,2820,2820,1538,4358
ΚΕΑΣ-ΚΥΘΝΟΥ,1205,0,0,0,0,2021-02-26T00:00:00,44,44,0,44
ΚΕΝΤΡΙΚΟΥ ΤΟΜΕΑ ΑΘΗΝΩΝ,905,1594,2416,-213,4010,2021-02-26T00:00:00,80473,80473,46878,127351
ΚΕΡΚΥΡΑΣ,603,37,121,-4,158,2021-02-26T00:00:00,3904,3904,2660,6564
ΚΕΦΑΛΛΗΝΙΑΣ,604,48,25,-39,73,2021-02-26T00:00:00,2221,2221,1585,3806
ΚΙΛΚΙΣ,203,86,85,-83,171,2021-02-26T00:00:00,4159,4159,2309,6468
ΚΟΖΑΝΗΣ,303,190,195,-24,385,2021-02-26T00:00:00,6605,6605,3100,9705
ΚΟΡΙΝΘΙΑΣ,1003,173,153,-5,326,2021-02-26T00:00:00,5093,5093,2225,7318
ΚΩ,1206,52,6,-5,58,2021-02-26T00:00:00,1644,1644,902,2546
ΛΑΚΩΝΙΑΣ,1004,119,147,10,266,2021-02-26T00:00:00,4585,4585,2500,7085
ΛΑΡΙΣΑΣ,502,361,327,46,688,2021-02-26T00:00:00,12319,12319,6114,18433
ΛΑΣΙΘΙΟΥ,1302,85,120,-33,205,2021-02-26T00:00:00,4908,4908,3693,8601
ΛΕΣΒΟΥ,1102,52,119,11,171,2021-02-26T00:00:00,3107,3107,2355,5462
ΛΕΥΚΑΔΑΣ,605,52,54,7,106,2021-02-26T00:00:00,2029,2029,887,2916
ΛΗΜΝΟΥ,1103,3,39,24,42,2021-02-26T00:00:00,812,812,681,1493
ΜΑΓΝΗΣΙΑΣ,503,208,165,-28,373,2021-02-26T00:00:00,6751,6751,3488,10239
ΜΕΣΣΗΝΙΑΣ,1005,164,255,23,419,2021-02-26T00:00:00,7095,7095,4056,11151
ΜΗΛΟΥ,1207,1,23,6,24,2021-02-26T00:00:00,298,298,130,428
ΜΥΚΟΝΟΥ,1208,0,0,0,0,2021-02-26T00:00:00,165,165,142,307
ΝΑΞΟΥ,1209,3,3,-18,6,2021-02-26T00:00:00,473,473,408,881
ΝΗΣΩΝ,906,51,96,19,147,2021-02-26T00:00:00,2005,2005,1430,3435
ΝΟΤΙΟΥ ΤΟΜΕΑ ΑΘΗΝΩΝ,907,501,293,-2,794,2021-02-26T00:00:00,13247,13247,5737,18984
ΞΑΝΘΗΣ,105,104,96,-10,200,2021-02-26T00:00:00,3414,3414,1987,5401
ΠΑΡΟΥ,1210,0,12,-18,12,2021-02-26T00:00:00,304,304,272,576
ΠΕΙΡΑΙΩΣ,908,687,683,-2,1370,2021-02-26T00:00:00,20928,20928,11681,32609
ΠΕΛΛΑΣ,204,134,278,-39,412,2021-02-26T00:00:00,6941,6941,3894,10835
ΠΙΕΡΙΑΣ,205,72,197,-33,269,2021-02-26T00:00:00,4709,4709,2850,7559
ΠΡΕΒΕΖΑΣ,404,114,47,-6,161,2021-02-26T00:00:00,2614,2614,994,3608
ΡΕΘΥΜΝΟΥ,1303,163,33,-55,196,2021-02-26T00:00:00,3966,3966,2217,6183
ΡΟΔΟΠΗΣ,106,92,67,-40,159,2021-02-26T00:00:00,3250,3250,1558,4808
ΡΟΔΟΥ,1211,139,12,-17,151,2021-02-26T00:00:00,4034,4034,1963,5997
ΣΑΜΟΥ,1104,48,22,13,70,2021-02-26T00:00:00,1342,1342,767,2109
ΣΕΡΡΩΝ,206,250,135,-17,385,2021-02-26T00:00:00,6764,6764,2445,9209
ΣΠΟΡΑΔΩΝ,504,3,3,6,6,2021-02-26T00:00:00,289,289,203,492
ΣΥΡΟΥ,1212,3,27,6,30,2021-02-26T00:00:00,931,931,708,1639
ΤΗΝΟΥ,1213,0,6,-18,6,2021-02-26T00:00:00,309,309,266,575
ΤΡΙΚΑΛΩΝ,505,187,200,2,387,2021-02-26T00:00:00,7179,7179,3465,10644
ΦΘΙΩΤΙΔΑΣ,804,172,93,-47,265,2021-02-26T00:00:00,5526,5526,2825,8351
ΦΛΩΡΙΝΑΣ,304,53,73,-41,126,2021-02-26T00:00:00,2404,2404,1457,3861
ΦΩΚΙΔΑΣ,805,79,45,27,124,2021-02-26T00:00:00,1673,1673,840,2513
ΧΑΛΚΙΔΙΚΗΣ,207,192,74,-30,266,2021-02-26T00:00:00,4451,4451,1795,6246
ΧΑΝΙΩΝ,1304,196,327,-3,523,2021-02-26T00:00:00,8741,8741,5630,14371
ΧΙΟΥ,1105,81,38,-7,119,2021-02-26T00:00:00,2716,2716,978,3694
ΑΙΤΩΛΟΑΚΑΡΝΑΝΙΑΣ,701,245,170,9,415,2021-02-27T00:00:00,7060,7060,2987,10047
ΑΝΑΤΟΛΙΚΗΣ ΑΤΤΙΚΗΣ,901,309,527,-133,836,2021-02-27T00:00:00,13692,13692,7572,21264
ΑΝΔΡΟΥ,1201,0,0,-17,0,2021-02-27T00:00:00,297,297,260,557
ΑΡΓΟΛΙΔΑΣ,1001,167,87,-20,254,2021-02-27T00:00:00,4479,4479,2625,7104
ΑΡΚΑΔΙΑΣ,1002,146,121,-23,267,2021-02-27T00:00:00,4498,4498,2534,7032
ΑΡΤΑΣ,401,57,136,4,193,2021-02-27T00:00:00,3931,3931,2598,6529
ΑΧΑΪΑΣ,702,321,346,-44,667,2021-02-27T00:00:00,12649,12649,8922,21571
ΒΟΙΩΤΙΑΣ,801,207,100,-64,307,2021-02-27T00:00:00,5675,5675,2397,8072
ΒΟΡΕΙΟΥ ΤΟΜΕΑ ΑΘΗΝΩΝ,902,2974,905,-753,3879,2021-02-27T00:00:00,83515,83515,37789,121304
ΓΡΕΒΕΝΩΝ,301,53,31,-40,84,2021-02-27T00:00:00,1867,1867,861,2728
ΔΡΑΜΑΣ,101,131,107,14,238,2021-02-27T00:00:00,4503,4503,2552,7055
ΔΥΤΙΚΗΣ ΑΤΤΙΚΗΣ,903,121,39,-7,160,2021-02-27T00:00:00,4290,4290,2862,7152
ΔΥΤΙΚΟΥ ΤΟΜΕΑ ΑΘΗΝΩΝ,904,353,724,104,1077,2021-02-27T00:00:00,21506,21506,12622,34128
ΕΒΡΟΥ,102,186,158,-23,344,2021-02-27T00:00:00,8091,8091,4531,12622
ΕΥΒΟΙΑΣ,802,253,167,-102,420,2021-02-27T00:00:00,8597,8597,5415,14012
ΕΥΡΥΤΑΝΙΑΣ,803,28,22,-22,50,2021-02-27T00:00:00,1016,1016,613,1629
ΖΑΚΥΝΘΟΥ,601,8,22,-28,30,2021-02-27T00:00:00,1536,1536,1228,2764
ΗΛΕΙΑΣ,703,122,116,-73,238,2021-02-27T00:00:00,5196,5196,3406,8602
ΗΜΑΘΙΑΣ,201,134,198,-37,332,2021-02-27T00:00:00,6508,6508,3365,9873
ΗΡΑΚΛΕΙΟΥ,1301,471,196,-15,667,2021-02-27T00:00:00,13781,13781,8618,22399
ΘΑΣΟΥ,103,4,32,6,36,2021-02-27T00:00:00,434,434,375,809
ΘΕΣΠΡΩΤΙΑΣ,402,59,58,-55,117,2021-02-27T00:00:00,2902,2902,1790,4692
ΘΕΣΣΑΛΟΝΙΚΗΣ,202,2131,1475,-21,3606,2021-02-27T00:00:00,66190,66190,34259,100449
ΘΗΡΑΣ,1202,2,4,0,6,2021-02-27T00:00:00,398,398,309,707
ΙΘΑΚΗΣ,602,60,0,60,60,2021-02-27T00:00:00,188,188,3,191
ΙΚΑΡΙΑΣ,1101,115,263,308,378,2021-02-27T00:00:00,963,963,654,1617
ΙΩΑΝΝΙΝΩΝ,403,248,239,-42,487,2021-02-27T00:00:00,10760,10760,6730,17490
ΚΑΒΑΛΑΣ,104,144,154,14,298,2021-02-27T00:00:00,5726,5726,3431,9157
ΚΑΛΥΜΝΟΥ,1203,28,2,-185,30,2021-02-27T00:00:00,980,980,663,1643
ΚΑΡΔΙΤΣΑΣ,501,339,114,-10,453,2021-02-27T00:00:00,7048,7048,3610,10658
ΚΑΡΠΑΘΟΥ,1204,0,0,0,0,2021-02-27T00:00:00,278,278,245,523
ΚΑΣΤΟΡΙΑΣ,302,76,72,-5,148,2021-02-27T00:00:00,2896,2896,1610,4506
ΚΕΑΣ-ΚΥΘΝΟΥ,1205,0,0,0,0,2021-02-27T00:00:00,44,44,0,44
ΚΕΝΤΡΙΚΟΥ ΤΟΜΕΑ ΑΘΗΝΩΝ,905,1527,2053,-430,3580,2021-02-27T00:00:00,82000,82000,48931,130931
ΚΕΡΚΥΡΑΣ,603,83,103,28,186,2021-02-27T00:00:00,3987,3987,2763,6750
ΚΕΦΑΛΛΗΝΙΑΣ,604,9,5,-59,14,2021-02-27T00:00:00,2230,2230,1590,3820
ΚΙΛΚΙΣ,203,78,53,-40,131,2021-02-27T00:00:00,4237,4237,2362,6599
ΚΟΖΑΝΗΣ,303,176,190,-19,366,2021-02-27T00:00:00,6781,6781,3290,10071
ΚΟΡΙΝΘΙΑΣ,1003,171,155,0,326,2021-02-27T00:00:00,5264,5264,2380,7644
ΚΩ,1206,44,2,-12,46,2021-02-27T00:00:00,1688,1688,904,2592
ΛΑΚΩΝΙΑΣ,1004,144,129,7,273,2021-02-27T00:00:00,4729,4729,2629,7358
ΛΑΡΙΣΑΣ,502,365,275,-48,640,2021-02-27T00:00:00,12684,12684,6389,19073
ΛΑΣΙΘΙΟΥ,1302,58,73,-74,131,2021-02-27T00:00:00,4966,4966,3766,8732
ΛΕΣΒΟΥ,1102,72,95,-4,167,2021-02-27T00:00:00,3179,3179,2450,5629
ΛΕΥΚΑΔΑΣ,605,58,42,-6,100,2021-02-27T00:00:00,2087,2087,929,3016
ΛΗΜΝΟΥ,1103,5,25,-12,30,2021-02-27T00:00:00,817,817,706,1523
ΜΑΓΝΗΣΙΑΣ,503,231,169,27,400,2021-02-27T00:00:00,6982,6982,3657,10639
ΜΕΣΣΗΝΙΑΣ,1005,183,225,-11,408,2021-02-27T00:00:00,7278,7278,4281,11559
ΜΗΛΟΥ,1207,1,16,-7,17,2021-02-27T00:00:00,299,299,146,445
ΜΥΚΟΝΟΥ,1208,5,1,6,6,2021-02-27T00:00:00,170,170,143,313
ΝΑΞΟΥ,1209,2,4,0,6,2021-02-27T00:00:00,475,475,412,887
ΝΗΣΩΝ,906,22,67,-58,89,2021-02-27T00:00:00,2027,2027,1497,3524
ΝΟΤΙΟΥ ΤΟΜΕΑ ΑΘΗΝΩΝ,907,534,257,-3,791,2021-02-27T00:00:00,13781,13781,5994,19775
ΞΑΝΘΗΣ,105,135,52,-13,187,2021-02-27T00:00:00,3549,3549,2039,5588
ΠΑΡΟΥ,1210,0,6,-6,6,2021-02-27T00:00:00,304,304,278,582
ΠΕΙΡΑΙΩΣ,908,529,565,-276,1094,2021-02-27T00:00:00,21457,21457,12246,33703
ΠΕΛΛΑΣ,204,144,262,-6,406,2021-02-27T00:00:00,7085,7085,4156,11241
ΠΙΕΡΙΑΣ,205,66,186,-17,252,2021-02-27T00:00:00,4775,4775,3036,7811
ΠΡΕΒΕΖΑΣ,404,117,38,-6,155,2021-02-27T00:00:00,2731,2731,1032,3763
ΡΕΘΥΜΝΟΥ,1303,98,44,-54,142,2021-02-27T00:00:00,4064,4064,2261,6325
ΡΟΔΟΠΗΣ,106,78,52,-29,130,2021-02-27T00:00:00,3328,3328,1610,4938
ΡΟΔΟΥ,1211,116,100,65,216,2021-02-27T00:00:00,4150,4150,2063,6213
ΣΑΜΟΥ,1104,46,30,6,76,2021-02-27T00:00:00,1388,1388,797,2185
ΣΕΡΡΩΝ,206,273,126,14,399,2021-02-27T00:00:00,7037,7037,2571,9608
ΣΠΟΡΑΔΩΝ,504,0,0,-6,0,2021-02-27T00:00:00,289,289,203,492
ΣΥΡΟΥ,1212,2,52,24,54,2021-02-27T00:00:00,933,933,760,1693
ΤΗΝΟΥ,1213,0,6,0,6,2021-02-27T00:00:00,309,309,272,581
ΤΡΙΚΑΛΩΝ,505,200,171,-16,371,2021-02-27T00:00:00,7379,7379,3636,11015
ΦΘΙΩΤΙΔΑΣ,804,177,70,-18,247,2021-02-27T00:00:00,5703,5703,2895,8598
ΦΛΩΡΙΝΑΣ,304,69,47,-10,116,2021-02-27T00:00:00,2473,2473,1504,3977
ΦΩΚΙΔΑΣ,805,39,45,-40,84,2021-02-27T00:00:00,1712,1712,885,2597
ΧΑΛΚΙΔΙΚΗΣ,207,184,51,-31,235,2021-02-27T00:00:00,4635,4635,1846,6481
ΧΑΝΙΩΝ,1304,205,266,-52,471,2021-02-27T00:00:00,8946,8946,5896,14842
ΧΙΟΥ,1105,56,28,-35,84,2021-02-27T00:00:00,2772,2772,1006,3778
ΑΙΤΩΛΟΑΚΑΡΝΑΝΙΑΣ,701,321,152,58,473,2021-03-01T00:00:00,7381,7381,3139,10520
ΑΝΑΤΟΛΙΚΗΣ ΑΤΤΙΚΗΣ,901,543,446,153,989,2021-03-01T00:00:00,14235,14235,8018,22253
ΑΝΔΡΟΥ,1201,0,0,0,0,2021-03-01T00:00:00,297,297,260,557
ΑΡΓΟΛΙΔΑΣ,1001,181,94,21,275,2021-03-01T00:00:00,4660,4660,2719,7379
ΑΡΚΑΔΙΑΣ,1002,204,77,14,281,2021-03-01T00:00:00,4702,4702,2611,7313
ΑΡΤΑΣ,401,63,114,-16,177,2021-03-01T00:00:00,3994,3994,2712,6706
ΑΧΑΪΑΣ,702,526,199,58,725,2021-03-01T00:00:00,13175,13175,9121,22296
ΒΟΙΩΤΙΑΣ,801,369,88,150,457,2021-03-01T00:00:00,6044,6044,2485,8529
ΒΟΡΕΙΟΥ ΤΟΜΕΑ ΑΘΗΝΩΝ,902,3313,1218,652,4531,2021-03-01T00:00:00,86828,86828,39007,125835
ΓΡΕΒΕΝΩΝ,301,66,70,52,136,2021-03-01T00:00:00,1933,1933,931,2864
ΔΡΑΜΑΣ,101,160,155,77,315,2021-03-01T00:00:00,4663,4663,2707,7370
ΔΥΤΙΚΗΣ ΑΤΤΙΚΗΣ,903,319,21,180,340,2021-03-01T00:00:00,4609,4609,2883,7492
ΔΥΤΙΚΟΥ ΤΟΜΕΑ ΑΘΗΝΩΝ,904,475,1009,407,1484,2021-03-01T00:00:00,21981,21981,13631,35612
ΕΒΡΟΥ,102,320,178,154,498,2021-03-01T00:00:00,8411,8411,4709,13120
ΕΥΒΟΙΑΣ,802,445,98,123,543,2021-03-01T00:00:00,9042,9042,5513,14555
ΕΥΡΥΤΑΝΙΑΣ,803,38,14,2,52,2021-03-01T00:00:00,1054,1054,627,1681
ΖΑΚΥΝΘΟΥ,601,37,28,35,65,2021-03-01T00:00:00,1573,1573,1256,2829
ΗΛΕΙΑΣ,703,302,64,128,366,2021-03-01T00:00:00,5498,5498,3470,8968
ΗΜΑΘΙΑΣ,201,205,194,67,399,2021-03-01T00:00:00,6713,6713,3559,10272
ΗΡΑΚΛΕΙΟΥ,1301,569,155,57,724,2021-03-01T00:00:00,14350,14350,8773,23123
ΘΑΣΟΥ,103,3,21,-12,24,2021-03-01T00:00:00,437,437,396,833
ΘΕΣΠΡΩΤΙΑΣ,402,85,147,115,232,2021-03-01T00:00:00,2987,2987,1937,4924
ΘΕΣΣΑΛΟΝΙΚΗΣ,202,2549,1523,466,4072,2021-03-01T00:00:00,68739,68739,35782,104521
ΘΗΡΑΣ,1202,29,7,30,36,2021-03-01T00:00:00,427,427,316,743
ΙΘΑΚΗΣ,602,54,0,-6,54,2021-03-01T00:00:00,242,242,3,245
ΙΚΑΡΙΑΣ,1101,82,3,-293,85,2021-03-01T00:00:00,1045,1045,657,1702
ΙΩΑΝΝΙΝΩΝ,403,306,211,30,517,2021-03-01T00:00:00,11066,11066,6941,18007
ΚΑΒΑΛΑΣ,104,148,184,34,332,2021-03-01T00:00:00,5874,5874,3615,9489
ΚΑΛΥΜΝΟΥ,1203,54,7,31,61,2021-03-01T00:00:00,1034,1034,670,1704
ΚΑΡΔΙΤΣΑΣ,501,388,90,25,478,2021-03-01T00:00:00,7436,7436,3700,11136
ΚΑΡΠΑΘΟΥ,1204,11,1,12,12,2021-03-01T00:00:00,289,289,246,535
ΚΑΣΤΟΡΙΑΣ,302,113,103,68,216,2021-03-01T00:00:00,3009,3009,1713,4722
ΚΕΑΣ-ΚΥΘΝΟΥ,1205,0,0,0,0,2021-03-01T00:00:00,44,44,0,44
ΚΕΝΤΡΙΚΟΥ ΤΟΜΕΑ ΑΘΗΝΩΝ,905,2437,2362,1219,4799,2021-03-01T00:00:00,84437,84437,51293,135730
ΚΕΡΚΥΡΑΣ,603,201,91,106,292,2021-03-01T00:00:00,4188,4188,2854,7042
ΚΕΦΑΛΛΗΝΙΑΣ,604,192,13,191,205,2021-03-01T00:00:00,2422,2422,1603,4025
ΚΙΛΚΙΣ,203,133,135,137,268,2021-03-01T00:00:00,4370,4370,2497,6867
ΚΟΖΑΝΗΣ,303,261,231,126,492,2021-03-01T00:00:00,7042,7042,3521,10563
ΚΟΡΙΝΘΙΑΣ,1003,253,119,46,372,2021-03-01T00:00:00,5517,5517,2499,8016
ΚΩ,1206,127,3,84,130,2021-03-01T00:00:00,1815,1815,907,2722
ΛΑΚΩΝΙΑΣ,1004,197,97,21,294,2021-03-01T00:00:00,4926,4926,2726,7652
ΛΑΡΙΣΑΣ,502,543,202,105,745,2021-03-01T00:00:00,13227,13227,6591,19818
ΛΑΣΙΘΙΟΥ,1302,142,51,62,193,2021-03-01T00:00:00,5108,5108,3817,8925
ΛΕΣΒΟΥ,1102,130,61,24,191,2021-03-01T00:00:00,3309,3309,2511,5820
ΛΕΥΚΑΔΑΣ,605,96,32,28,128,2021-03-01T00:00:00,2183,2183,961,3144
ΛΗΜΝΟΥ,1103,26,16,12,42,2021-03-01T00:00:00,843,843,722,1565
ΜΑΓΝΗΣΙΑΣ,503,352,166,118,518,2021-03-01T00:00:00,7334,7334,3823,11157
ΜΕΣΣΗΝΙΑΣ,1005,238,195,25,433,2021-03-01T00:00:00,7516,7516,4476,11992
ΜΗΛΟΥ,1207,0,26,9,26,2021-03-01T00:00:00,299,299,172,471
ΜΥΚΟΝΟΥ,1208,0,0,-6,0,2021-03-01T00:00:00,170,170,143,313
ΝΑΞΟΥ,1209,29,1,24,30,2021-03-01T00:00:00,504,504,413,917
ΝΗΣΩΝ,906,79,45,35,124,2021-03-01T00:00:00,2106,2106,1542,3648
ΝΟΤΙΟΥ ΤΟΜΕΑ ΑΘΗΝΩΝ,907,587,343,139,930,2021-03-01T00:00:00,14368,14368,6337,20705
ΞΑΝΘΗΣ,105,133,94,40,227,2021-03-01T00:00:00,3682,3682,2133,5815
ΠΑΡΟΥ,1210,0,6,0,6,2021-03-01T00:00:00,304,304,284,588
ΠΕΙΡΑΙΩΣ,908,738,694,338,1432,2021-03-01T00:00:00,22195,22195,12940,35135
ΠΕΛΛΑΣ,204,256,252,102,508,2021-03-01T00:00:00,7341,7341,4408,11749
ΠΙΕΡΙΑΣ,205,116,178,42,294,2021-03-01T00:00:00,4891,4891,3214,8105
ΠΡΕΒΕΖΑΣ,404,167,27,39,194,2021-03-01T00:00:00,2898,2898,1059,3957
ΡΕΘΥΜΝΟΥ,1303,220,35,113,255,2021-03-01T00:00:00,4284,4284,2296,6580
ΡΟΔΟΠΗΣ,106,134,88,92,222,2021-03-01T00:00:00,3462,3462,1698,5160
ΡΟΔΟΥ,1211,113,127,24,240,2021-03-01T00:00:00,4263,4263,2190,6453
ΣΑΜΟΥ,1104,70,33,27,103,2021-03-01T00:00:00,1458,1458,830,2288
ΣΕΡΡΩΝ,206,326,163,90,489,2021-03-01T00:00:00,7363,7363,2734,10097
ΣΠΟΡΑΔΩΝ,504,0,0,0,0,2021-03-01T00:00:00,289,289,203,492
ΣΥΡΟΥ,1212,4,44,-6,48,2021-03-01T00:00:00,937,937,804,1741
ΤΗΝΟΥ,1213,0,6,0,6,2021-03-01T00:00:00,309,309,278,587
ΤΡΙΚΑΛΩΝ,505,216,201,46,417,2021-03-01T00:00:00,7595,7595,3837,11432
ΦΘΙΩΤΙΔΑΣ,804,228,108,89,336,2021-03-01T00:00:00,5931,5931,3003,8934
ΦΛΩΡΙΝΑΣ,304,135,42,61,177,2021-03-01T00:00:00,2608,2608,1546,4154
ΦΩΚΙΔΑΣ,805,76,43,35,119,2021-03-01T00:00:00,1788,1788,928,2716
ΧΑΛΚΙΔΙΚΗΣ,207,236,166,167,402,2021-03-01T00:00:00,4871,4871,2012,6883
ΧΑΝΙΩΝ,1304,287,259,75,546,2021-03-01T00:00:00,9233,9233,6155,15388
ΧΙΟΥ,1105,123,63,102,186,2021-03-01T00:00:00,2895,2895,1069,3964
ΑΙΤΩΛΟΑΚΑΡΝΑΝΙΑΣ,701,360,154,41,514,2021-03-02T00:00:00,7741,7741,3293,11034
ΑΝΑΤΟΛΙΚΗΣ ΑΤΤΙΚΗΣ,901,554,450,15,1004,2021-03-02T00:00:00,14789,14789,8468,23257
ΑΝΔΡΟΥ,1201,0,1,1,1,2021-03-02T00:00:00,297,297,261,558
ΑΡΓΟΛΙΔΑΣ,1001,199,43,-33,242,2021-03-02T00:00:00,4859,4859,2762,7621
ΑΡΚΑΔΙΑΣ,1002,180,56,-45,236,2021-03-02T00:00:00,4882,4882,2667,7549
ΑΡΤΑΣ,401,64,102,-11,166,2021-03-02T00:00:00,4058,4058,2814,6872
ΑΧΑΪΑΣ,702,622,141,38,763,2021-03-02T00:00:00,13797,13797,9262,23059
ΒΟΙΩΤΙΑΣ,801,416,51,10,467,2021-03-02T00:00:00,6460,6460,2536,8996
ΒΟΡΕΙΟΥ ΤΟΜΕΑ ΑΘΗΝΩΝ,902,3424,1301,194,4725,2021-03-02T00:00:00,90252,90252,40308,130560
ΓΡΕΒΕΝΩΝ,301,62,64,-10,126,2021-03-02T00:00:00,1995,1995,995,2990
ΔΡΑΜΑΣ,101,108,135,-72,243,2021-03-02T00:00:00,4771,4771,2842,7613
ΔΥΤΙΚΗΣ ΑΤΤΙΚΗΣ,903,370,8,38,378,2021-03-02T00:00:00,4979,4979,2891,7870
ΔΥΤΙΚΟΥ ΤΟΜΕΑ ΑΘΗΝΩΝ,904,468,994,-22,1462,2021-03-02T00:00:00,22449,22449,14625,37074
ΕΒΡΟΥ,102,328,154,-16,482,2021-03-02T00:00:00,8739,8739,4863,13602
ΕΥΒΟΙΑΣ,802,576,59,92,635,2021-03-02T00:00:00,9618,9618,5572,15190
ΕΥΡΥΤΑΝΙΑΣ,803,53,8,9,61,2021-03-02T00:00:00,1107,1107,635,1742
ΖΑΚΥΝΘΟΥ,601,73,11,19,84,2021-03-02T00:00:00,1646,1646,1267,2913
ΗΛΕΙΑΣ,703,293,54,-19,347,2021-03-02T00:00:00,5791,5791,3524,9315
ΗΜΑΘΙΑΣ,201,206,188,-5,394,2021-03-02T00:00:00,6919,6919,3747,10666
ΗΡΑΚΛΕΙΟΥ,1301,617,89,-18,706,2021-03-02T00:00:00,14967,14967,8862,23829
ΘΑΣΟΥ,103,3,15,-6,18,2021-03-02T00:00:00,440,440,411,851
ΘΕΣΠΡΩΤΙΑΣ,402,160,90,18,250,2021-03-02T00:00:00,3147,3147,2027,5174
ΘΕΣΣΑΛΟΝΙΚΗΣ,202,2810,1342,80,4152,2021-03-02T00:00:00,71549,71549,37124,108673
ΘΗΡΑΣ,1202,30,0,-6,30,2021-03-02T00:00:00,457,457,316,773
ΙΘΑΚΗΣ,602,60,0,6,60,2021-03-02T00:00:00,302,302,3,305
ΙΚΑΡΙΑΣ,1101,53,2,-30,55,2021-03-02T00:00:00,1098,1098,659,1757
ΙΩΑΝΝΙΝΩΝ,403,304,206,-7,510,2021-03-02T00:00:00,11370,11370,7147,18517
ΚΑΒΑΛΑΣ,104,138,179,-15,317,2021-03-02T00:00:00,6012,6012,3794,9806
ΚΑΛΥΜΝΟΥ,1203,35,0,-26,35,2021-03-02T00:00:00,1069,1069,670,1739
ΚΑΡΔΙΤΣΑΣ,501,361,56,-61,417,2021-03-02T00:00:00,7797,7797,3756,11553
ΚΑΡΠΑΘΟΥ,1204,30,0,18,30,2021-03-02T00:00:00,319,319,246,565
ΚΑΣΤΟΡΙΑΣ,302,121,103,8,224,2021-03-02T00:00:00,3130,3130,1816,4946
ΚΕΑΣ-ΚΥΘΝΟΥ,1205,0,0,0,0,2021-03-02T00:00:00,44,44,0,44
ΚΕΝΤΡΙΚΟΥ ΤΟΜΕΑ ΑΘΗΝΩΝ,905,2406,2297,-96,4703,2021-03-02T00:00:00,86843,86843,53590,140433
ΚΕΡΚΥΡΑΣ,603,204,97,9,301,2021-03-02T00:00:00,4392,4392,2951,7343
ΚΕΦΑΛΛΗΝΙΑΣ,604,159,1,-45,160,2021-03-02T00:00:00,2581,2581,1604,4185
ΚΙΛΚΙΣ,203,229,112,73,341,2021-03-02T00:00:00,4599,4599,2609,7208
ΚΟΖΑΝΗΣ,303,268,211,-13,479,2021-03-02T00:00:00,7310,7310,3732,11042
ΚΟΡΙΝΘΙΑΣ,1003,204,143,-25,347,2021-03-02T00:00:00,5721,5721,2642,8363
ΚΩ,1206,150,4,24,154,2021-03-02T00:00:00,1965,1965,911,2876
ΛΑΚΩΝΙΑΣ,1004,243,18,-33,261,2021-03-02T00:00:00,5169,5169,2744,7913
ΛΑΡΙΣΑΣ,502,416,242,-87,658,2021-03-02T00:00:00,13643,13643,6833,20476
ΛΑΣΙΘΙΟΥ,1302,334,19,160,353,2021-03-02T00:00:00,5442,5442,3836,9278
ΛΕΣΒΟΥ,1102,180,17,6,197,2021-03-02T00:00:00,3489,3489,2528,6017
ΛΕΥΚΑΔΑΣ,605,205,250,327,455,2021-03-02T00:00:00,2388,2388,1211,3599
ΛΗΜΝΟΥ,1103,39,9,6,48,2021-03-02T00:00:00,882,882,731,1613
ΜΑΓΝΗΣΙΑΣ,503,385,114,-19,499,2021-03-02T00:00:00,7719,7719,3937,11656
ΜΕΣΣΗΝΙΑΣ,1005,240,150,-43,390,2021-03-02T00:00:00,7756,7756,4626,12382
ΜΗΛΟΥ,1207,2,6,-18,8,2021-03-02T00:00:00,301,301,178,479
ΜΥΚΟΝΟΥ,1208,0,0,0,0,2021-03-02T00:00:00,170,170,143,313
ΝΑΞΟΥ,1209,25,5,0,30,2021-03-02T00:00:00,529,529,418,947
ΝΗΣΩΝ,906,94,32,2,126,2021-03-02T00:00:00,2200,2200,1574,3774
ΝΟΤΙΟΥ ΤΟΜΕΑ ΑΘΗΝΩΝ,907,562,407,39,969,2021-03-02T00:00:00,14930,14930,6744,21674
ΞΑΝΘΗΣ,105,160,80,13,240,2021-03-02T00:00:00,3842,3842,2213,6055
ΠΑΡΟΥ,1210,0,0,-6,0,2021-03-02T00:00:00,304,304,284,588
ΠΕΙΡΑΙΩΣ,908,905,555,28,1460,2021-03-02T00:00:00,23100,23100,13495,36595
ΠΕΛΛΑΣ,204,256,182,-70,438,2021-03-02T00:00:00,7597,7597,4590,12187
ΠΙΕΡΙΑΣ,205,152,141,-1,293,2021-03-02T00:00:00,5043,5043,3355,8398
ΠΡΕΒΕΖΑΣ,404,178,14,-2,192,2021-03-02T00:00:00,3076,3076,1073,4149
ΡΕΘΥΜΝΟΥ,1303,285,31,61,316,2021-03-02T00:00:00,4569,4569,2327,6896
ΡΟΔΟΠΗΣ,106,141,67,-14,208,2021-03-02T00:00:00,3603,3603,1765,5368
ΡΟΔΟΥ,1211,174,72,6,246,2021-03-02T00:00:00,4437,4437,2262,6699
ΣΑΜΟΥ,1104,84,29,10,113,2021-03-02T00:00:00,1542,1542,859,2401
ΣΕΡΡΩΝ,206,302,139,-48,441,2021-03-02T00:00:00,7665,7665,2873,10538
ΣΠΟΡΑΔΩΝ,504,18,0,18,18,2021-03-02T00:00:00,307,307,203,510
ΣΥΡΟΥ,1212,23,31,6,54,2021-03-02T00:00:00,960,960,835,1795
ΤΗΝΟΥ,1213,5,1,0,6,2021-03-02T00:00:00,314,314,279,593
ΤΡΙΚΑΛΩΝ,505,230,184,-3,414,2021-03-02T00:00:00,7825,7825,4021,11846
ΦΘΙΩΤΙΔΑΣ,804,244,92,0,336,2021-03-02T00:00:00,6175,6175,3095,9270
ΦΛΩΡΙΝΑΣ,304,160,31,14,191,2021-03-02T00:00:00,2768,2768,1577,4345
ΦΩΚΙΔΑΣ,805,84,16,-19,100,2021-03-02T00:00:00,1872,1872,944,2816
ΧΑΛΚΙΔΙΚΗΣ,207,333,132,63,465,2021-03-02T00:00:00,5204,5204,2144,7348
ΧΑΝΙΩΝ,1304,378,224,56,602,2021-03-02T00:00:00,9611,9611,6379,15990
ΧΙΟΥ,1105,149,55,18,204,2021-03-02T00:00:00,3044,3044,1124,4168
ΑΙΤΩΛΟΑΚΑΡΝΑΝΙΑΣ,701,362,136,-16,498,2021-03-03T00:00:00,8103,8103,3429,11532
ΑΝΑΤΟΛΙΚΗΣ ΑΤΤΙΚΗΣ,901,703,266,-35,969,2021-03-03T00:00:00,15492,15492,8734,24226
ΑΝΔΡΟΥ,1201,0,0,-1,0,2021-03-03T00:00:00,297,297,261,558
ΑΡΓΟΛΙΔΑΣ,1001,205,14,-23,219,2021-03-03T00:00:00,5064,5064,2776,7840
ΑΡΚΑΔΙΑΣ,1002,182,32,-22,214,2021-03-03T00:00:00,5064,5064,2699,7763
ΑΡΤΑΣ,401,104,47,-15,151,2021-03-03T00:00:00,4162,4162,2861,7023
ΑΧΑΪΑΣ,702,639,101,-23,740,2021-03-03T00:00:00,14436,14436,9363,23799
ΒΟΙΩΤΙΑΣ,801,422,25,-20,447,2021-03-03T00:00:00,6882,6882,2561,9443
ΒΟΡΕΙΟΥ ΤΟΜΕΑ ΑΘΗΝΩΝ,902,3419,586,-720,4005,2021-03-03T00:00:00,93671,93671,40894,134565
ΓΡΕΒΕΝΩΝ,301,50,69,-7,119,2021-03-03T00:00:00,2045,2045,1064,3109
ΔΡΑΜΑΣ,101,177,91,25,268,2021-03-03T00:00:00,4948,4948,2933,7881
ΔΥΤΙΚΗΣ ΑΤΤΙΚΗΣ,903,374,14,10,388,2021-03-03T00:00:00,5353,5353,2905,8258
ΔΥΤΙΚΟΥ ΤΟΜΕΑ ΑΘΗΝΩΝ,904,664,782,-16,1446,2021-03-03T00:00:00,23113,23113,15407,38520
ΕΒΡΟΥ,102,402,74,-6,476,2021-03-03T00:00:00,9141,9141,4937,14078
ΕΥΒΟΙΑΣ,802,585,23,-27,608,2021-03-03T00:00:00,10203,10203,5595,15798
ΕΥΡΥΤΑΝΙΑΣ,803,46,6,-9,52,2021-03-03T00:00:00,1153,1153,641,1794
ΖΑΚΥΝΘΟΥ,601,87,8,11,95,2021-03-03T00:00:00,1733,1733,1275,3008
ΗΛΕΙΑΣ,703,331,27,11,358,2021-03-03T00:00:00,6122,6122,3551,9673
ΗΜΑΘΙΑΣ,201,228,137,-29,365,2021-03-03T00:00:00,7147,7147,3884,11031
ΗΡΑΚΛΕΙΟΥ,1301,650,84,28,734,2021-03-03T00:00:00,15617,15617,8946,24563
ΘΑΣΟΥ,103,0,6,-12,6,2021-03-03T00:00:00,440,440,417,857
ΘΕΣΠΡΩΤΙΑΣ,402,190,62,2,252,2021-03-03T00:00:00,3337,3337,2089,5426
ΘΕΣΣΑΛΟΝΙΚΗΣ,202,3057,1017,-78,4074,2021-03-03T00:00:00,74606,74606,38141,112747
ΘΗΡΑΣ,1202,39,9,18,48,2021-03-03T00:00:00,496,496,325,821
ΙΘΑΚΗΣ,602,60,0,0,60,2021-03-03T00:00:00,362,362,3,365
ΙΚΑΡΙΑΣ,1101,38,3,-14,41,2021-03-03T00:00:00,1136,1136,662,1798
ΙΩΑΝΝΙΝΩΝ,403,345,141,-24,486,2021-03-03T00:00:00,11715,11715,7288,19003
ΚΑΒΑΛΑΣ,104,198,118,-1,316,2021-03-03T00:00:00,6210,6210,3912,10122
ΚΑΛΥΜΝΟΥ,1203,24,0,-11,24,2021-03-03T00:00:00,1093,1093,670,1763
ΚΑΡΔΙΤΣΑΣ,501,341,23,-53,364,2021-03-03T00:00:00,8138,8138,3779,11917
ΚΑΡΠΑΘΟΥ,1204,24,0,-6,24,2021-03-03T00:00:00,343,343,246,589
ΚΑΣΤΟΡΙΑΣ,302,140,68,-16,208,2021-03-03T00:00:00,3270,3270,1884,5154
ΚΕΑΣ-ΚΥΘΝΟΥ,1205,0,0,0,0,2021-03-03T00:00:00,44,44,0,44
ΚΕΝΤΡΙΚΟΥ ΤΟΜΕΑ ΑΘΗΝΩΝ,905,2791,1873,-39,4664,2021-03-03T00:00:00,89634,89634,55463,145097
ΚΕΡΚΥΡΑΣ,603,273,33,5,306,2021-03-03T00:00:00,4665,4665,2984,7649
ΚΕΦΑΛΛΗΝΙΑΣ,604,149,5,-6,154,2021-03-03T00:00:00,2730,2730,1609,4339
ΚΙΛΚΙΣ,203,138,111,-92,249,2021-03-03T00:00:00,4737,4737,2720,7457
ΚΟΖΑΝΗΣ,303,266,190,-23,456,2021-03-03T00:00:00,7576,7576,3922,11498
ΚΟΡΙΝΘΙΑΣ,1003,251,89,-7,340,2021-03-03T00:00:00,5972,5972,2731,8703
ΚΩ,1206,155,2,3,157,2021-03-03T00:00:00,2120,2120,913,3033
ΛΑΚΩΝΙΑΣ,1004,250,12,1,262,2021-03-03T00:00:00,5419,5419,2756,8175
ΛΑΡΙΣΑΣ,502,326,199,-133,525,2021-03-03T00:00:00,13969,13969,7032,21001
ΛΑΣΙΘΙΟΥ,1302,313,24,-16,337,2021-03-03T00:00:00,5755,5755,3860,9615
ΛΕΣΒΟΥ,1102,179,18,0,197,2021-03-03T00:00:00,3668,3668,2546,6214
ΛΕΥΚΑΔΑΣ,605,107,137,-211,244,2021-03-03T00:00:00,2495,2495,1348,3843
ΛΗΜΝΟΥ,1103,37,11,0,48,2021-03-03T00:00:00,919,919,742,1661
ΜΑΓΝΗΣΙΑΣ,503,395,115,11,510,2021-03-03T00:00:00,8114,8114,4052,12166
ΜΕΣΣΗΝΙΑΣ,1005,247,105,-38,352,2021-03-03T00:00:00,8003,8003,4731,12734
ΜΗΛΟΥ,1207,2,26,20,28,2021-03-03T00:00:00,303,303,204,507
ΜΥΚΟΝΟΥ,1208,0,0,0,0,2021-03-03T00:00:00,170,170,143,313
ΝΑΞΟΥ,1209,43,4,17,47,2021-03-03T00:00:00,572,572,422,994
ΝΗΣΩΝ,906,100,39,13,139,2021-03-03T00:00:00,2300,2300,1613,3913
ΝΟΤΙΟΥ ΤΟΜΕΑ ΑΘΗΝΩΝ,907,645,322,-2,967,2021-03-03T00:00:00,15575,15575,7066,22641
ΞΑΝΘΗΣ,105,200,37,-3,237,2021-03-03T00:00:00,4042,4042,2250,6292
ΠΑΡΟΥ,1210,0,6,6,6,2021-03-03T00:00:00,304,304,290,594
ΠΕΙΡΑΙΩΣ,908,1112,302,-46,1414,2021-03-03T00:00:00,24212,24212,13797,38009
ΠΕΛΛΑΣ,204,345,140,47,485,2021-03-03T00:00:00,7942,7942,4730,12672
ΠΙΕΡΙΑΣ,205,158,123,-12,281,2021-03-03T00:00:00,5201,5201,3478,8679
ΠΡΕΒΕΖΑΣ,404,167,12,-13,179,2021-03-03T00:00:00,3243,3243,1085,4328
ΡΕΘΥΜΝΟΥ,1303,279,25,-12,304,2021-03-03T00:00:00,4848,4848,2352,7200
ΡΟΔΟΠΗΣ,106,147,69,8,216,2021-03-03T00:00:00,3750,3750,1834,5584
ΡΟΔΟΥ,1211,165,46,-35,211,2021-03-03T00:00:00,4602,4602,2308,6910
ΣΑΜΟΥ,1104,83,10,-20,93,2021-03-03T00:00:00,1625,1625,869,2494
ΣΕΡΡΩΝ,206,328,102,-11,430,2021-03-03T00:00:00,7993,7993,2975,10968
ΣΠΟΡΑΔΩΝ,504,42,18,42,60,2021-03-03T00:00:00,349,349,221,570
ΣΥΡΟΥ,1212,35,13,-6,48,2021-03-03T00:00:00,995,995,848,1843
ΤΗΝΟΥ,1213,0,0,-6,0,2021-03-03T00:00:00,314,314,279,593
ΤΡΙΚΑΛΩΝ,505,288,101,-25,389,2021-03-03T00:00:00,8113,8113,4122,12235
ΦΘΙΩΤΙΔΑΣ,804,240,103,7,343,2021-03-03T00:00:00,6415,6415,3198,9613
ΦΛΩΡΙΝΑΣ,304,178,29,16,207,2021-03-03T00:00:00,2946,2946,1606,4552
ΦΩΚΙΔΑΣ,805,77,7,-16,84,2021-03-03T00:00:00,1949,1949,951,2900
ΧΑΛΚΙΔΙΚΗΣ,207,314,95,-56,409,2021-03-03T00:00:00,5518,5518,2239,7757
ΧΑΝΙΩΝ,1304,451,91,-60,542,2021-03-03T00:00:00,10062,10062,6470,16532
ΧΙΟΥ,1105,119,176,91,295,2021-03-03T00:00:00,3163,3163,1300,4463
